Abiotrophia	Aerococcaceae
Acanthopleuribacter	Acanthopleuribacteraceae
Acaricomes	Micrococcaceae
Acetanaerobacterium	Ruminococcaceae
Acetatifactor	Lachnospiraceae
Acetitomaculum	Lachnospiraceae
Acetivibrio	Ruminococcaceae
Acetoanaerobium	Unclassified_Clostridiales
Acetobacter	Acetobacteraceae
Acetobacterium	Eubacteriaceae
Acetobacteroides	Rikenellaceae
Acetohalobium	Halobacteroidaceae
Acetomicrobium	Bacteroidaceae
Acetonema	Veillonellaceae
Acholeplasma	Acholeplasmataceae
Achromobacter	Alcaligenaceae
Acidaminobacter	Unclassified_Clostridiales
Acidaminococcus	Acidaminococcaceae
Acidianus	Sulfolobaceae
Acidicaldus	Acetobacteraceae
Acidicapsa	Acidobacteriaceae
Acidiferrobacter	Ectothiorhodospiraceae
Acidilobus	Acidilobaceae
Acidimicrobium	Acidimicrobiaceae
Acidiphilium	Acetobacteraceae
Acidiplasma	Ferroplasmaceae
Acidisoma	Acetobacteraceae
Acidisphaera	Acetobacteraceae
Aciditerrimonas	Unclassified_Acidimicrobineae
Acidithiobacillus	Acidithiobacillaceae
Acidobacterium	Acidobacteriaceae
Acidocella	Acetobacteraceae
Acidomonas	Acetobacteraceae
Acidothermus	Acidothermaceae
Acidovorax	Comamonadaceae
Acinetobacter	Moraxellaceae
Acrocarpospora	Streptosporangiaceae
Actibacter	Flavobacteriaceae
Actibacterium	Rhodobacteraceae
Actinoallomurus	Thermomonosporaceae
Actinoalloteichus	Pseudonocardiaceae
Actinobacillus	Pasteurellaceae
Actinobaculum	Actinomycetaceae
Actinocatenispora	Micromonosporaceae
Actinocorallia	Thermomonosporaceae
Actinokineospora	Pseudonocardiaceae
Actinomadura	Thermomonosporaceae
Actinomyces	Actinomycetaceae
Actinomycetospora	Pseudonocardiaceae
Actinophytocola	Pseudonocardiaceae
Actinoplanes	Micromonosporaceae
Actinopolymorpha	Nocardioidaceae
Actinopolyspora	Actinopolysporaceae
Actinospica	Actinospicaceae
Actinosynnema	Pseudonocardiaceae
Actinotalea	Cellulomonadaceae
Actinotignum	Actinomycetaceae
Adhaeribacter	Cytophagaceae
Adlercreutzia	Eggerthellaceae
Advenella	Alcaligenaceae
Aequorivita	Flavobacteriaceae
Aeribacillus	Bacillaceae
Aeriscardovia	Bifidobacteriaceae
Aerococcus	Aerococcaceae
Aeromicrobium	Nocardioidaceae
Aeromonas	Aeromonadaceae
Aeropyrum	Desulfurococcaceae
Aestuariibacter	Alteromonadaceae
Aestuariibaculum	Flavobacteriaceae
Aestuariihabitans	Rhodobacteraceae
Aestuariimicrobium	Propionibacteriaceae
Aestuariispira	Rhodospirillaceae
Aestuarivita	Rhodobacteraceae
Afifella	Rhodobiaceae
Afipia	Bradyrhizobiaceae
Agaricicola	Rhodobacteraceae
Agarivorans	Alteromonadaceae
Aggregatibacter	Pasteurellaceae
Aggregicoccus	Myxococcaceae
Agreia	Microbacteriaceae
Agrococcus	Microbacteriaceae
Agromyces	Microbacteriaceae
Ahrensia	Rhodobacteraceae
Aidingimonas	Halomonadaceae
Akkermansia	Akkermansiaceae
Albibacter	Methylocystaceae
Albidiferax	Comamonadaceae
Albidovulum	Rhodobacteraceae
Albimonas	Rhodobacteraceae
Albirhodobacter	Rhodobacteraceae
Alcaligenes	Alcaligenaceae
Alcanivorax	Alcanivoracaceae
Algibacter	Flavobacteriaceae
Algicola	Pseudoalteromonadaceae
Algimonas	Hyphomonadaceae
Algiphilus	Algiphilaceae
Algoriphagus	Cyclobacteriaceae
Aliagarivorans	Alteromonadaceae
Alicycliphilus	Comamonadaceae
Alicyclobacillus	Alicyclobacillaceae
Aliidiomarina	Idiomarinaceae
Aliifodinibius	Unclassified_Sphingobacteriales
Aliiglaciecola	Alteromonadaceae
Aliivibrio	Vibrionaceae
Alishewanella	Alteromonadaceae
Alistipes	Rikenellaceae
Alkalibacillus	Bacillaceae
Alkalibacter	Eubacteriaceae
Alkalibacterium	Carnobacteriaceae
Alkalibaculum	Eubacteriaceae
Alkaliflexus	Marinilabiliaceae
Alkalilimnicola	Ectothiorhodospiraceae
Alkalimonas	Unclassified_Gammaproteobacteria
Alkalinema	Oscillatoriales
Alkaliphilus	Clostridiaceae
Alkalispirillum	Ectothiorhodospiraceae
Alkalitalea	Marinilabiliaceae
Alkanibacter	Nevskiaceae
Alkanindiges	Moraxellaceae
Allisonella	Veillonellaceae
Alloactinosynnema	Pseudonocardiaceae
Allobacillus	Bacillaceae
Allobaculum	Erysipelotrichaceae
Allocatelliglobosispora	Micromonosporaceae
Allochromatium	Chromatiaceae
Allofustis	Carnobacteriaceae
Alloiococcus	Carnobacteriaceae
Allokutzneria	Pseudonocardiaceae
Allonocardiopsis	Unclassified_Streptosporangineae
Alloprevotella	Prevotellaceae
Allosalinactinospora	Nocardiopsaceae
Alloscardovia	Bifidobacteriaceae
Alpinimonas	Microbacteriaceae
Alsobacter	Unclassified_Rhizobiales
Altererythrobacter	Erythrobacteraceae
Alteribacillus	Bacillaceae
Alterococcus	Opitutaceae
Alteromonas	Alteromonadaceae
Alysiella	Neisseriaceae
Amantichitinum	Neisseriaceae
Amaricoccus	Rhodobacteraceae
Ameyamaea	Acetobacteraceae
Aminicella	Eubacteriaceae
Aminiphilus	Synergistaceae
Aminivibrio	Synergistaceae
Aminobacter	Phyllobacteriaceae
Aminobacterium	Synergistaceae
Ammonifex	Thermoanaerobacteraceae
Ammonibacillus	Unclassified_Bacillales
Ammoniphilus	Paenibacillaceae
Amnibacterium	Microbacteriaceae
Amorphus	Unclassified_Rhizobiales
Amphibacillus	Bacillaceae
Amphiplicatus	Parvularculaceae
Amphritea	Oceanospirillaceae
Amycolatopsis	Pseudonocardiaceae
Amycolicicoccus	Mycobacteriaceae
Amylibacter	Rhodobacteraceae
Anaeroarcus	Veillonellaceae
Anaerobacillus	Bacillaceae
Anaerobacter	Clostridiaceae
Anaerobacterium	Ruminococcaceae
Anaerobaculum	Synergistaceae
Anaerobiospirillum	Succinivibrionaceae
Anaerobranca	Unclassified_Clostridiales
Anaerocella	Rikenellaceae
Anaerococcus	Unclassified_Clostridiales
Anaerofilum	Ruminococcaceae
Anaerofustis	Eubacteriaceae
Anaeroglobus	Veillonellaceae
Anaerolinea	Anaerolineaceae
Anaeromusa	Veillonellaceae
Anaeromyxobacter	Anaeromyxobacteraceae
Anaerophaga	Marinilabiliaceae
Anaeroplasma	Anaeroplasmataceae
Anaerorhabdus	Bacteroidaceae
Anaerosalibacter	Clostridiaceae
Anaerosinus	Veillonellaceae
Anaerosolibacter	Clostridiaceae
Anaerosphaera	Peptostreptococcaceae
Anaerosporobacter	Clostridiaceae
Anaerostipes	Lachnospiraceae
Anaerotruncus	Ruminococcaceae
Anaerovibrio	Veillonellaceae
Anaerovirgula	Unclassified_Clostridiales
Anaerovorax	Unclassified_Clostridiales
Anaplasma	Anaplasmataceae
Ancylobacter	Xanthobacteraceae
Anderseniella	Rhodobiaceae
Andreprevotia	Neisseriaceae
Aneurinibacillus	Paenibacillaceae
Angulomicrobium	Hyphomicrobiaceae
Angustibacter	Kineosporiaceae
Anoxybacillus	Bacillaceae
Anoxybacter	Unclassified_Halanaerobiales
Anoxynatronum	Clostridiaceae
Antarcticimonas	Flavobacteriaceae
Antarctobacter	Rhodobacteraceae
Aquabacter	Hyphomicrobiaceae
Aquabacterium	Unclassified_Burkholderiales
Aquamicrobium	Phyllobacteriaceae
Aquaspirillum	Neisseriaceae
Aquibacillus	Bacillaceae
Aquibacter	Flavobacteriaceae
Aquicella	Coxiellaceae
Aquifex	Aquificaceae
Aquiflexum	Cyclobacteriaceae
Aquihabitans	Iamiaceae
Aquimarina	Flavobacteriaceae
Aquimonas	Rhodanobacteraceae
Aquincola	Unclassified_Burkholderiales
Aquipuribacter	Intrasporangiaceae
Aquisalibacillus	Bacillaceae
Aquisalimonas	Ectothiorhodospiraceae
Aquisphaera	Planctomycetaceae
Aquitalea	Neisseriaceae
Arachidicoccus	Chitinophagaceae
Arcanobacterium	Actinomycetaceae
Archaeoglobus	Archaeoglobaceae
Archangium	Cystobacteraceae
Arcicella	Cytophagaceae
Arcobacter	Campylobacteraceae
Arcticibacter	Sphingobacteriaceae
Ardenticatena	Ardenticatenia
Arenibacter	Flavobacteriaceae
Arenicella	Arenicellaceae
Arenimonas	Lysobacteraceae
Arenitalea	Flavobacteriaceae
Arhodomonas	Ectothiorhodospiraceae
Aridibacter	Unclassified_Elusimicrobia
Armatimonas	Armatimonadaceae
Arsenicicoccus	Intrasporangiaceae
Arsenophonus	Enterobacteriaceae
Arthrobacter	Micrococcaceae
Asaccharobacter	Eggerthellaceae
Asaccharospora	Clostridiaceae
Asaia	Acetobacteraceae
Asanoa	Micromonosporaceae
Ascidiaceihabitans	Rhodobacteraceae
Asinibacterium	Chitinophagaceae
Asteroleplasma	Anaeroplasmataceae
Asticcacaulis	Caulobacteraceae
Atopobacter	Carnobacteriaceae
Atopobium	Atopobacteriaceae
Atopococcus	Carnobacteriaceae
Atopostipes	Carnobacteriaceae
Aurantimonas	Aurantimonadaceae
Auraticoccus	Propionibacteriaceae
Aureibacter	Flammeovirgaceae
Aureicoccus	Flavobacteriaceae
Aureimonas	Aurantimonadaceae
Aureispira	Saprospiraceae
Aureitalea	Flavobacteriaceae
Aureivirga	Flavobacteriaceae
Auritidibacter	Micrococcaceae
Austwickia	Dermatophilaceae
Avibacterium	Pasteurellaceae
Azoarcus	Rhodocyclaceae
Azohydromonas	Alcaligenaceae
Azomonas	Pseudomonadaceae
Azonexus	Rhodocyclaceae
Azorhizobium	Xanthobacteraceae
Azorhizophilus	Pseudomonadaceae
Azospira	Rhodocyclaceae
Azospirillum	Rhodospirillaceae
Azotobacter	Pseudomonadaceae
Azovibrio	Rhodocyclaceae
Bacillus	Bacillaceae
Bacteriovorax	Bacteriovoracaceae
Bacteroides	Bacteroidaceae
Balnearium	Desulfurobacteriaceae
Balneatrix	Oceanospirillaceae
Balneola	Chitinophagaceae
Barnesiella	Porphyromonadaceae
Barrientosiimonas	Dermacoccaceae
Bartonella	Bartonellaceae
Basfia	Pasteurellaceae
Basilea	Alcaligenaceae
Bauldia	Unclassified_Rhizobiales
Bavariicoccus	Enterococcaceae
Bdellovibrio	Bdellovibrionaceae
Beggiatoa	Thiotrichaceae
Beijerinckia	Beijerinckiaceae
Belliella	Cyclobacteriaceae
Bellilinea	Anaerolineaceae
Belnapia	Acetobacteraceae
Bergeriella	Neisseriaceae
Bermanella	Oceanospirillaceae
Beutenbergia	Beutenbergiaceae
Bhargavaea	Planococcaceae
Bibersteinia	Pasteurellaceae
Bifidobacterium	Bifidobacteriaceae
Bilophila	Desulfovibrionaceae
Biostraticola	Enterobacteriaceae
Bisgaardia	Pasteurellaceae
Bizionia	Flavobacteriaceae
Blastobacter	Bradyrhizobiaceae
Blastocatella	Unclassified_Elusimicrobia
Blastochloris	Hyphomicrobiaceae
Blastococcus	Geodermatophilaceae
Blastomonas	Sphingomonadaceae
Blastopirellula	Planctomycetaceae
Blautia	Unclassified_Clostridiales
Bogoriella	Bogoriellaceae
Bombella	Acetobacteraceae
Bombiscardovia	Bifidobacteriaceae
Bordetella	Alcaligenaceae
Borrelia	Spirochaetaceae
Borreliella	Spirochaetaceae
Bosea	Bradyrhizobiaceae
Boseongicola	Rhodobacteraceae
Bowmanella	Alteromonadaceae
Brachybacterium	Dermabacteraceae
Brachymonas	Comamonadaceae
Brachyspira	Brachyspiraceae
Brackiella	Alcaligenaceae
Bradymonas	Bradymonadaceae
Bradyrhizobium	Bradyrhizobiaceae
Branchiibius	Dermacoccaceae
Brassicibacter	Clostridiaceae
Brenneria	Enterobacteriaceae
Breoghania	Unclassified_Alphaproteobacteria
Brevibacillus	Paenibacillaceae
Brevibacterium	Brevibacteriaceae
Brevifollis	Verrucomicrobiaceae
Brevinema	Brevinemataceae
Brevundimonas	Caulobacteraceae
Brochothrix	Listeriaceae
Brockia	Thermoanaerobacteraceae
Brooklawnia	Propionibacteriaceae
Brucella	Brucellaceae
Brumimicrobium	Cryomorphaceae
Bryobacter	Unclassified_Acidobacteria
Bryocella	Acidobacteriaceae
Budvicia	Enterobacteriaceae
Bulleidia	Erysipelotrichaceae
Burkholderia	Burkholderiaceae
Buttiauxella	Enterobacteriaceae
Butyricicoccus	Clostridiaceae
Butyricimonas	Porphyromonadaceae
Butyrivibrio	Lachnospiraceae
Byssovorax	Polyangiaceae
Caedibacter	Unclassified_Thiotrichales
Caenimonas	Comamonadaceae
Caenispirillum	Rhodospirillaceae
Caldalkalibacillus	Bacillaceae
Caldanaerobacter	Thermoanaerobacteraceae
Caldanaerobius	Thermoanaerobacteraceae
Caldanaerovirga	Unclassified_Thermoanaerobacterales
Calderihabitans	Thermoanaerobacteraceae
Caldibacillus	Bacillaceae
Caldicellulosiruptor	Unclassified_Thermoanaerobacterales
Caldicoprobacter	Caldicoprobacteraceae
Caldilinea	Caldilineaceae
Caldimicrobium	Thermodesulfobacteriaceae
Caldimonas	Comamonadaceae
Caldisericum	Caldisericaceae
Caldisphaera	Caldisphaeraceae
Calditerricola	Bacillaceae
Calditerrivibrio	Deferribacteraceae
Caldithrix	Unclassified_Deferribacterales
Caldivirga	Thermoproteaceae
Calidifontibacter	Dermacoccaceae
Caloramator	Clostridiaceae
Caloranaerobacter	Clostridiaceae
Caloribacterium	Thermoanaerobacteraceae
Camelimonas	Beijerinckiaceae
Caminibacter	Nautiliaceae
Caminicella	Clostridiaceae
Campylobacter	Campylobacteraceae
Candidimonas	Alcaligenaceae
Canibacter	Microbacteriaceae
Capnocytophaga	Flavobacteriaceae
Carboxydocella	Unclassified_Clostridiales
Carboxydothermus	Thermoanaerobacteraceae
Carboxylicivirga	Marinilabiliaceae
Cardiobacterium	Cardiobacteriaceae
Carnimonas	Halomonadaceae
Carnobacterium	Carnobacteriaceae
Caryophanon	Planococcaceae
Castellaniella	Alcaligenaceae
Catabacter	Unclassified_Clostridiales
Catalinimonas	Catalimonadaceae
Catellatospora	Micromonosporaceae
Catellicoccus	Enterococcaceae
Catelliglobosispora	Micromonosporaceae
Catenibacterium	Erysipelotrichaceae
Catenisphaera	Erysipelotrichaceae
Catenovulum	Alteromonadaceae
Catenulispora	Catenulisporaceae
Catenuloplanes	Micromonosporaceae
Catonella	Lachnospiraceae
Caulobacter	Caulobacteraceae
Cecembia	Cyclobacteriaceae
Cedecea	Enterobacteriaceae
Celeribacter	Rhodobacteraceae
Celerinatantimonas	Celerinatantimonadaceae
Cellulomonas	Cellulomonadaceae
Cellulophaga	Flavobacteriaceae
Cellulosibacter	Clostridiaceae
Cellulosilyticum	Lachnospiraceae
Cellulosimicrobium	Promicromonosporaceae
Cellvibrio	Pseudomonadaceae
Centipeda	Veillonellaceae
Cerasibacillus	Bacillaceae
Cerasicoccus	Puniceicoccaceae
Cereibacter	Rhodobacteraceae
Cesiribacter	Flammeovirgaceae
Cetia	Nautiliaceae
Cetobacterium	Fusobacteriaceae
Chalicogloea	Chroococcales
Chelativorans	Phyllobacteriaceae
Chelatococcus	Beijerinckiaceae
Chelonobacter	Pasteurellaceae
Chiayiivirga	Lysobacteraceae
Chishuiella	Flavobacteriaceae
Chitinibacter	Neisseriaceae
Chitinilyticum	Neisseriaceae
Chitinimonas	Burkholderiaceae
Chitiniphilus	Neisseriaceae
Chitinivibrio	Chitinivibrionaceae
Chitinivorax	Unclassified_Betaproteobacteria
Chitinophaga	Chitinophagaceae
Chlamydia	Chlamydiaceae
Chlamydophila	Chlamydiaceae
Chloracidobacterium	Acidobacteriaceae
Chlorobaculum	Chlorobiaceae
Chlorobium	Chlorobiaceae
Chloroflexus	Chloroflexaceae
Chloroherpeton	Chlorobiaceae
Chondromyces	Polyangiaceae
Christensenella	Christensenellaceae
Chromatium	Chromatiaceae
Chromatocurvus	Unclassified_Gammaproteobacteria
Chromobacterium	Chromobacteriaceae
Chromohalobacter	Halomonadaceae
Chryseobacterium	Flavobacteriaceae
Chryseoglobus	Microbacteriaceae
Chryseolinea	Unclassified_Cytophagales
Chryseomicrobium	Planococcaceae
Chrysiogenes	Chrysiogenaceae
Chthonomonas	Chthonomonadaceae
Chungangia	Unclassified_Bacillales
Ciceribacter	Rhizobiaceae
Citreicella	Rhodobacteraceae
Citreimonas	Rhodobacteraceae
Citreitalea	Flavobacteriaceae
Citricoccus	Micrococcaceae
Citrobacter	Enterobacteriaceae
Clavibacter	Microbacteriaceae
Cloacibacillus	Synergistaceae
Cloacibacterium	Flavobacteriaceae
Clostridiisalibacter	Clostridiaceae
Clostridium	Clostridiaceae
Cnuella	Chitinophagaceae
Cobetia	Halomonadaceae
Cocleimonas	Thiotrichaceae
Coenonia	Flavobacteriaceae
Cohaesibacter	Cohaesibacteraceae
Cohnella	Paenibacillaceae
Collimonas	Oxalobacteraceae
Collinsella	Coriobacteriaceae
Colwellia	Colwelliaceae
Comamonas	Comamonadaceae
Compostibacillus	Bacillaceae
Compostimonas	Microbacteriaceae
Conchiformibius	Neisseriaceae
Conexibacter	Conexibacteraceae
Confluentimicrobium	Rhodobacteraceae
Congregibacter	Unclassified_Alteromonadales
Constrictibacter	Rhodospirillaceae
Conyzicola	Microbacteriaceae
Coprobacillus	Erysipelotrichaceae
Coprobacter	Porphyromonadaceae
Coprococcus	Lachnospiraceae
Coprothermobacter	Thermodesulfobiaceae
Coraliomargarita	Puniceicoccaceae
Corallibacter	Flavobacteriaceae
Corallococcus	Myxococcaceae
Corallomonas	Oceanospirillaceae
Coriobacterium	Coriobacteriaceae
Corynebacterium	Corynebacteriaceae
Cosenzaea	Enterobacteriaceae
Costertonia	Flavobacteriaceae
Couchioplanes	Micromonosporaceae
Coxiella	Coxiellaceae
Craurococcus	Acetobacteraceae
Crenobacter	Neisseriaceae
Crenotalea	Chitinophagaceae
Cribrihabitans	Rhodobacteraceae
Cricetibacter	Pasteurellaceae
Crinalium	Oscillatoriales
Croceibacter	Flavobacteriaceae
Croceicoccus	Erythrobacteraceae
Croceitalea	Flavobacteriaceae
Crocinitomix	Cryomorphaceae
Cronobacter	Enterobacteriaceae
Crossiella	Pseudonocardiaceae
Cruoricaptor	Flavobacteriaceae
Cryobacterium	Microbacteriaceae
Cryomorpha	Cryomorphaceae
Cryptanaerobacter	Peptococcaceae
Cryptobacterium	Eggerthellaceae
Cryptosporangium	Cryptosporangiaceae
Cucumibacter	Hyphomicrobiaceae
Cupriavidus	Burkholderiaceae
Curtobacterium	Microbacteriaceae
Curvibacter	Comamonadaceae
Cyclobacterium	Cyclobacteriaceae
Cycloclasticus	Piscirickettsiaceae
Cystobacter	Cystobacteraceae
Cytophaga	Cytophagaceae
Dactylosporangium	Micromonosporaceae
Daeguia	Brucellaceae
Dasania	Unclassified_Pseudomonadales
Dechloromonas	Rhodocyclaceae
Deefgea	Neisseriaceae
Deferribacter	Deferribacteraceae
Deferrisoma	Unclassified_Deltaproteobacteria
Defluviicoccus	Rhodospirillaceae
Defluviimonas	Rhodobacteraceae
Defluviitalea	Defluviitaleaceae
Defluviitoga	Thermotogaceae
Dehalobacter	Peptococcaceae
Dehalococcoides	Dehalococcoidaceae
Dehalogenimonas	Dehalococcoidaceae
Deinobacterium	Deinococcaceae
Deinococcus	Deinococcaceae
Delftia	Comamonadaceae
Demequina	Demequinaceae
Demetria	Dermacoccaceae
Dendrosporobacter	Veillonellaceae
Denitratisoma	Rhodocyclaceae
Denitrobacterium	Eggerthellaceae
Denitrovibrio	Deferribacteraceae
Dermabacter	Dermabacteraceae
Dermacoccus	Dermacoccaceae
Dermatophilus	Dermatophilaceae
Derxia	Alcaligenaceae
Desemzia	Carnobacteriaceae
Desertibacter	Rhodospirillaceae
Desmospora	Thermoactinomycetaceae
Desulfacinum	Syntrophobacteraceae
Desulfarculus	Desulfarculaceae
Desulfatibacillum	Desulfobacteraceae
Desulfatiferula	Desulfobacteraceae
Desulfatiglans	Desulfarculaceae
Desulfatirhabdium	Desulfobacteraceae
Desulfatitalea	Desulfobacteraceae
Desulfitibacter	Peptococcaceae
Desulfitispora	Peptococcaceae
Desulfitobacterium	Peptococcaceae
Desulfobacca	Syntrophaceae
Desulfobacter	Desulfobacteraceae
Desulfobacterium	Desulfobacteraceae
Desulfobacula	Desulfobacteraceae
Desulfobaculum	Desulfovibrionaceae
Desulfobotulus	Desulfobacteraceae
Desulfobulbus	Desulfobulbaceae
Desulfocapsa	Desulfobulbaceae
Desulfocarbo	Desulfarculaceae
Desulfocella	Desulfobacteraceae
Desulfococcus	Desulfobacteraceae
Desulfoconvexum	Desulfobacteraceae
Desulfocurvus	Desulfovibrionaceae
Desulfofaba	Desulfobacteraceae
Desulfofrigus	Desulfobacteraceae
Desulfofustis	Desulfobulbaceae
Desulfoglaeba	Syntrophobacteraceae
Desulfohalobium	Desulfohalobiaceae
Desulfoluna	Desulfobacteraceae
Desulfomicrobium	Desulfomicrobiaceae
Desulfomonile	Syntrophaceae
Desulfonatronobacter	Desulfobacteraceae
Desulfonatronospira	Desulfohalobiaceae
Desulfonatronovibrio	Desulfohalobiaceae
Desulfonatronum	Desulfonatronaceae
Desulfonauticus	Desulfohalobiaceae
Desulfonema	Desulfobacteraceae
Desulfonispora	Peptococcaceae
Desulfopila	Desulfobulbaceae
Desulfoprunum	Desulfobulbaceae
Desulforegula	Desulfobacteraceae
Desulforhabdus	Syntrophobacteraceae
Desulforhopalus	Desulfobulbaceae
Desulfosalsimonas	Desulfobacteraceae
Desulfosarcina	Desulfobacteraceae
Desulfosoma	Syntrophobacteraceae
Desulfospira	Desulfobacteraceae
Desulfosporosinus	Peptococcaceae
Desulfotalea	Desulfobulbaceae
Desulfothermus	Desulfohalobiaceae
Desulfotignum	Desulfobacteraceae
Desulfotomaculum	Peptococcaceae
Desulfovermiculus	Desulfohalobiaceae
Desulfovibrio	Desulfovibrionaceae
Desulfovirga	Syntrophobacteraceae
Desulfovirgula	Thermoanaerobacteraceae
Desulfurella	Desulfurellaceae
Desulfuribacillus	Unclassified_Bacillales
Desulfurispira	Chrysiogenaceae
Desulfurispirillum	Chrysiogenaceae
Desulfurispora	Peptococcaceae
Desulfurivibrio	Desulfobulbaceae
Desulfurobacterium	Desulfurobacteriaceae
Desulfurococcus	Desulfurococcaceae
Desulfuromonas	Desulfuromonadaceae
Desulfuromusa	Desulfuromonadaceae
Dethiobacter	Syntrophomonadaceae
Dethiosulfatibacter	Unclassified_Clostridiales
Dethiosulfovibrio	Synergistaceae
Devosia	Hyphomicrobiaceae
Devriesea	Dermabacteraceae
Dialister	Veillonellaceae
Diaminobutyricibacter	Microbacteriaceae
Diaminobutyricimonas	Microbacteriaceae
Diaphorobacter	Comamonadaceae
Dichelobacter	Cardiobacteriaceae
Dichotomicrobium	Hyphomicrobiaceae
Dickeya	Enterobacteriaceae
Dictyoglomus	Dictyoglomaceae
Dietzia	Dietziaceae
Dinoroseobacter	Rhodobacteraceae
Diplorickettsia	Coxiellaceae
Dissulfuribacter	Unclassified_Deltaproteobacteria
Dokdonella	Rhodanobacteraceae
Dokdonia	Flavobacteriaceae
Dolosicoccus	Aerococcaceae
Dolosigranulum	Carnobacteriaceae
Domibacillus	Bacillaceae
Donghicola	Rhodobacteraceae
Dongia	Rhodospirillaceae
Dorea	Lachnospiraceae
Draconibacterium	Prolixibacteraceae
Duganella	Oxalobacteraceae
Dyadobacter	Cytophagaceae
Dyella	Rhodanobacteraceae
Dysgonomonas	Porphyromonadaceae
Echinicola	Cyclobacteriaceae
Echinimonas	Vibrionaceae
Ectothiorhodosinus	Ectothiorhodospiraceae
Ectothiorhodospira	Ectothiorhodospiraceae
Edaphobacter	Acidobacteriaceae
Edwardsiella	Enterobacteriaceae
Effusibacillus	Alicyclobacillaceae
Eggerthella	Eggerthellaceae
Eggerthia	Erysipelotrichaceae
Ehrlichia	Anaplasmataceae
Eikenella	Neisseriaceae
Eilatimonas	Unclassified_Alphaproteobacteria
Eionea	Unclassified_Alteromonadales
Eisenbergiella	Clostridiaceae
Ekhidna	Cytophagaceae
Elioraea	Unclassified_Rhodospirillales
Elizabethkingia	Flavobacteriaceae
Elstera	Rhodospirillaceae
Elusimicrobium	Elusimicrobiaceae
Empedobacter	Flavobacteriaceae
Emticicia	Cytophagaceae
Endobacter	Acetobacteraceae
Endozoicomonas	Hahellaceae
Enhydrobacter	Moraxellaceae
Enhygromyxa	Nannocystaceae
Ensifer	Rhizobiaceae
Enteractinococcus	Micrococcaceae
Enterobacter	Enterobacteriaceae
Enterococcus	Enterococcaceae
Enterorhabdus	Eggerthellaceae
Enterovibrio	Vibrionaceae
Entomoplasma	Entomoplasmataceae
Eoetvoesia	Alcaligenaceae
Epibacterium	Rhodobacteraceae
Epilithonimonas	Flavobacteriaceae
Ercella	Ruminococcaceae
Eremococcus	Aerococcaceae
Erwinia	Enterobacteriaceae
Erysipelothrix	Erysipelotrichaceae
Erythrobacter	Erythrobacteraceae
Erythromicrobium	Erythrobacteraceae
Escherichia	Enterobacteriaceae
Ethanoligenens	Ruminococcaceae
Eubacterium	Eubacteriaceae
Eudoraea	Flavobacteriaceae
Euzebya	Euzebyaceae
Euzebyella	Flavobacteriaceae
Exiguobacterium	Unclassified_Bacillales
Exilispira	Unclassified_Spirochaetales
Extensimonas	Comamonadaceae
Ezakiella	Peptoniphilaceae
Fabibacter	Flammeovirgaceae
Facklamia	Aerococcaceae
Faecalibacterium	Ruminococcaceae
Faecalicoccus	Streptococcaceae
Faecalitalea	Eubacteriaceae
Falsibacillus	Bacillaceae
Falsiporphyromonas	Porphyromonadaceae
Falsirhodobacter	Rhodobacteraceae
Falsochrobactrum	Brucellaceae
Fangia	Unclassified_Thiotrichales
Fastidiosipila	Ruminococcaceae
Faucicola	Moraxellaceae
Ferribacterium	Rhodocyclaceae
Ferrimicrobium	Acidimicrobiaceae
Ferrimonas	Ferrimonadaceae
Ferriphaselus	Rhodocyclaceae
Ferrithrix	Acidimicrobiaceae
Ferroglobus	Archaeoglobaceae
Ferroplasma	Ferroplasmaceae
Ferrovibrio	Rhodospirillaceae
Ferruginibacter	Chitinophagaceae
Fervidicella	Clostridiaceae
Fervidicoccus	Fervidicoccaceae
Fervidicola	Syntrophomonadaceae
Fervidobacterium	Fervidobacteraceae
Fibrella	Cytophagaceae
Fibrisoma	Cytophagaceae
Fibrobacter	Fibrobacteraceae
Fictibacillus	Bacillaceae
Filibacter	Planococcaceae
Filifactor	Peptostreptococcaceae
Filimonas	Chitinophagaceae
Filobacillus	Bacillaceae
Filomicrobium	Hyphomicrobiaceae
Fimbriimonas	Fimbriimonadaceae
Finegoldia	Unclassified_Clostridiales
Flagellimonas	Flavobacteriaceae
Flammeovirga	Flammeovirgaceae
Flavicella	Flavobacteriaceae
Flaviflexus	Actinomycetaceae
Flavihumibacter	Chitinophagaceae
Flavimarina	Flavobacteriaceae
Flaviramulus	Flavobacteriaceae
Flavirhabdus	Flavobacteriaceae
Flavisolibacter	Chitinophagaceae
Flavitalea	Chitinophagaceae
Flavivirga	Flavobacteriaceae
Flavobacterium	Flavobacteriaceae
Flavonifractor	Unclassified_Clostridiales
Flectobacillus	Cytophagaceae
Flexibacter	Cytophagaceae
Flexistipes	Deferribacteraceae
Flexithrix	Flammeovirgaceae
Flexivirga	Dermacoccaceae
Flindersiella	Nocardioidaceae
Fluviicola	Cryomorphaceae
Fluviimonas	Cytophagaceae
Fodinibacter	Intrasporangiaceae
Fodinibius	Unclassified_Sphingobacteriales
Fodinicola	Cryptosporangiaceae
Fodinicurvata	Rhodospirillaceae
Fontibacillus	Paenibacillaceae
Fontibacter	Cyclobacteriaceae
Fonticella	Clostridiaceae
Fontimonas	Nevskiaceae
Formivibrio	Neisseriaceae
Formosa	Flavobacteriaceae
Francisella	Francisellaceae
Franconibacter	Enterobacteriaceae
Frateuria	Rhodanobacteraceae
Frederiksenia	Pasteurellaceae
Fretibacter	Hyphomonadaceae
Fretibacterium	Synergistaceae
Friedmanniella	Propionibacteriaceae
Frigidibacter	Rhodobacteraceae
Frigoribacterium	Microbacteriaceae
Frischella	Orbaceae
Frondibacter	Flavobacteriaceae
Frondihabitans	Microbacteriaceae
Fructobacillus	Leuconostocaceae
Fuchsiella	Halobacteroidaceae
Fulvibacter	Flavobacteriaceae
Fulvimarina	Aurantimonadaceae
Fulvimonas	Rhodanobacteraceae
Fulvitalea	Flammeovirgaceae
Fulvivirga	Flammeovirgaceae
Fusibacter	Unclassified_Clostridiales
Fusicatenibacter	Clostridiaceae
Fusobacterium	Fusobacteriaceae
Gaetbulibacter	Flavobacteriaceae
Gaiella	Gaiellaceae
Galbibacter	Flavobacteriaceae
Galbitalea	Microbacteriaceae
Galenea	Piscirickettsiaceae
Gallaecimonas	Unclassified_Gammaproteobacteria
Gallibacterium	Pasteurellaceae
Gallicola	Unclassified_Clostridiales
Gangjinia	Flavobacteriaceae
Garciella	Eubacteriaceae
Gardnerella	Bifidobacteriaceae
Garicola	Micrococcaceae
Gelidibacter	Flavobacteriaceae
Gelria	Thermoanaerobacteraceae
Gemella	Unclassified_Bacillales
Geminicoccus	Unclassified_Alphaproteobacteria
Gemmata	Planctomycetaceae
Gemmatimonas	Gemmatimonadaceae
Gemmiger	Hyphomicrobiaceae
Gemmobacter	Rhodobacteraceae
Geoalkalibacter	Geobacteraceae
Geobacillus	Bacillaceae
Geobacter	Geobacteraceae
Geodermatophilus	Geodermatophilaceae
Geofilum	Marinilabiliaceae
Geoglobus	Archaeoglobaceae
Geojedonia	Flavobacteriaceae
Geomicrobium	Unclassified_Bacillales
Geopsychrobacter	Geobacteraceae
Georgenia	Bogoriellaceae
Georgfuchsia	Rhodocyclaceae
Geosporobacter	Clostridiaceae
Geothermobacter	Geobacteraceae
Geothermomicrobium	Thermoactinomycetaceae
Geothrix	Holophagaceae
Geotoga	Thermotogaceae
Geovibrio	Deferribacteraceae
Gibbsiella	Enterobacteriaceae
Giesbergeria	Comamonadaceae
Gilliamella	Orbaceae
Gillisia	Flavobacteriaceae
Gilvibacter	Flavobacteriaceae
Gilvimarinus	Unclassified_Alteromonadales
Gimesia	Planctomycetaceae
Glaciecola	Alteromonadaceae
Glaciibacter	Microbacteriaceae
Glaciihabitans	Microbacteriaceae
Glaciimonas	Oxalobacteraceae
Globicatella	Aerococcaceae
Gluconacetobacter	Acetobacteraceae
Gluconobacter	Acetobacteraceae
Glycocaulis	Hyphomonadaceae
Glycomyces	Glycomycetaceae
Goodfellowiella	Pseudonocardiaceae
Gordonia	Nocardiaceae
Gordonibacter	Eggerthellaceae
Gracilibacillus	Bacillaceae
Gracilibacter	Gracilibacteraceae
Gracilimonas	Chitinophagaceae
Gramella	Flavobacteriaceae
Granulibacter	Acetobacteraceae
Granulicatella	Carnobacteriaceae
Granulicella	Acidobacteriaceae
Granulicoccus	Propionibacteriaceae
Granulosicoccus	Granulosicoccaceae
Grimontia	Vibrionaceae
Gryllotalpicola	Microbacteriaceae
Guggenheimella	Unclassified_Clostridiales
Gulbenkiania	Neisseriaceae
Gulosibacter	Microbacteriaceae
Gynuella	Saccharospirillaceae
Haematobacter	Rhodobacteraceae
Haemophilus	Pasteurellaceae
Hafnia	Enterobacteriaceae
Hahella	Hahellaceae
Haladaptatus	Halobacteriaceae
Halalkalibacillus	Bacillaceae
Halalkalicoccus	Halobacteriaceae
Halanaerobacter	Halobacteroidaceae
Halanaerobaculum	Halobacteroidaceae
Halanaerobium	Halanaerobiaceae
Halapricum	Halobacteriaceae
Halarchaeum	Halobacteriaceae
Halarsenatibacter	Halanaerobiaceae
Haliangium	Haliangiaceae
Haliea	Alteromonadaceae
Halioglobus	Unclassified_Gammaproteobacteria
Haliscomenobacter	Saprospiraceae
Hallella	Prevotellaceae
Haloactinobacterium	Ruaniaceae
Haloactinopolyspora	Jiangellaceae
Haloactinospora	Nocardiopsaceae
Haloarchaeobius	Halobacteriaceae
Haloarcula	Halobacteriaceae
Halobacillus	Bacillaceae
Halobacteriovorax	Bacteriovoracaceae
Halobacterium	Halobacteriaceae
Halobacteroides	Halobacteroidaceae
Halobaculum	Haloferacaceae
Halobellus	Haloferacaceae
Halobiforma	Natrialbaceae
Halocalculus	Halobacteriaceae
Halocella	Halanaerobiaceae
Halochromatium	Chromatiaceae
Halococcus	Halobacteriaceae
Halocynthilibacter	Rhodobacteraceae
Haloechinothrix	Pseudonocardiaceae
Haloferax	Haloferacaceae
Haloferula	Verrucomicrobiaceae
Halogeometricum	Haloferacaceae
Halosarcina	Haloferacaceae
Haloglycomyces	Glycomycetaceae
Halogranum	Haloferacaceae
Halohasta	Haloferacaceae
Halolactibacillus	Bacillaceae
Halolamina	Haloferacaceae
Halomarina	Halobacteriaceae
Halomicroarcula	Halobacteriaceae
Halomicrobium	Halobacteriaceae
Halomonas	Halomonadaceae
Halonatronum	Halobacteroidaceae
Halonotius	Haloferacaceae
Halopelagius	Haloferacaceae
Halopenitus	Haloferacaceae
Halopiger	Natrialbaceae
Haloplanus	Haloferacaceae
Haloplasma	Haloplasmataceae
Halopolyspora	Unclassified_Actinopolysporineae
Haloquadratum	Haloferacaceae
Halorhabdus	Halobacteriaceae
Halorhodospira	Ectothiorhodospiraceae
Halorientalis	Halobacteriaceae
Hallorubellus	Halobacteriaceae
Halorubrum	Haloferacaceae
Halorussus	Halobacteriaceae
Halosimplex	Halobacteriaceae
Halospina	Hahellaceae
Halospirulina	Oscillatoriales
Halostagnicola	Natrialbaceae
Halotalea	Halomonadaceae
Haloterrigena	Natrialbaceae
Halothermothrix	Halanaerobiaceae
Halothiobacillus	Halothiobacillaceae
Halotia	Nostocales
Halovenus	Halobacteriaceae
Halovibrio	Halomonadaceae
Halovivax	Natrialbaceae
Hamadaea	Micromonosporaceae
Hansschlegelia	Methylocystaceae
Hanstruepera	Flavobacteriaceae
Hartmannibacter	Methylocystaceae
Hasllibacter	Rhodobacteraceae
Hazenella	Thermoactinomycetaceae
Helcobacillus	Dermabacteraceae
Helcococcus	Unclassified_Clostridiales
Helicobacter	Helicobacteraceae
Heliimonas	Chitinophagaceae
Heliobacillus	Heliobacteriaceae
Heliobacterium	Heliobacteriaceae
Heliorestis	Heliobacteriaceae
Hellea	Hyphomonadaceae
Henriciella	Hyphomonadaceae
Hephaestia	Sphingomonadaceae
Herbaspirillum	Oxalobacteraceae
Herbiconiux	Microbacteriaceae
Herbidospora	Streptosporangiaceae
Herminiimonas	Oxalobacteraceae
Herpetosiphon	Herpetosiphonaceae
Hespellia	Lachnospiraceae
Hippea	Desulfurellaceae
Hirschia	Hyphomonadaceae
Histophilus	Pasteurellaceae
Hoeflea	Phyllobacteriaceae
Holdemanella	Eubacteriaceae
Holdemania	Erysipelotrichaceae
Holophaga	Holophagaceae
Homoserinibacter	Microbacteriaceae
Homoserinimonas	Microbacteriaceae
Hoppeia	Flavobacteriaceae
Howardella	Unclassified_Clostridiales
Hoyosella	Unclassified_Corynebacterineae
Huanghella	Cytophagaceae
Humibacillus	Intrasporangiaceae
Humibacter	Microbacteriaceae
Humitalea	Acetobacteraceae
Hungatella	Clostridiaceae
Hwangdonia	Flavobacteriaceae
Hwanghaeicola	Rhodobacteraceae
Hyalangium	Cystobacteraceae
Hydrobacter	Chitinophagaceae
Hydrocarboniphaga	Nevskiaceae
Hydrogenibacillus	Bacillaceae
Hydrogenimonas	Hydrogenimonaceae
Hydrogenispora	Heliobacteriaceae
Hydrogenivirga	Aquificaceae
Hydrogenoanaerobacterium	Ruminococcaceae
Hydrogenobacter	Aquificaceae
Hydrogenobaculum	Aquificaceae
Hydrogenophaga	Comamonadaceae
Hydrogenophilus	Hydrogenophilaceae
Hydrogenovibrio	Piscirickettsiaceae
Hydrotalea	Chitinophagaceae
Hylemonella	Comamonadaceae
Hymenobacter	Cytophagaceae
Hyperthermus	Pyrodictiaceae
Hyphomicrobium	Hyphomicrobiaceae
Hyphomonas	Hyphomonadaceae
Hyunsoonleella	Flavobacteriaceae
Iamia	Iamiaceae
Ichthyenterobacterium	Flavobacteriaceae
Ideonella	Unclassified_Burkholderiales
Idiomarina	Idiomarinaceae
Ignatzschineria	Lysobacteraceae
Ignavibacterium	Ignavibacteriaceae
Ignavigranum	Aerococcaceae
Ignicoccus	Desulfurococcaceae
Ignisphaera	Desulfurococcaceae
Ilumatobacter	Acidimicrobiaceae
Ilyobacter	Fusobacteriaceae
Imperialibacter	Flammeovirgaceae
Imtechella	Flavobacteriaceae
Indibacter	Cyclobacteriaceae
Inhella	Unclassified_Burkholderiales
Inquilinus	Rhodospirillaceae
Insolitispirillum	Rhodospirillaceae
Intestinibacter	Clostridiaceae
Intestinimonas	Ruminococcaceae
Intrasporangium	Intrasporangiaceae
Iodobacter	Neisseriaceae
Iphinoe	Stigonematales
Isobaculum	Carnobacteriaceae
Isochromatium	Chromatiaceae
Isoptericola	Promicromonosporaceae
Isosphaera	Planctomycetaceae
Jahnella	Polyangiaceae
Janibacter	Intrasporangiaceae
Jannaschia	Rhodobacteraceae
Janthinobacterium	Oxalobacteraceae
Jatrophihabitans	Frankiaceae
Jejudonia	Flavobacteriaceae
Jejuia	Flavobacteriaceae
Jeongeupia	Neisseriaceae
Jeotgalibaca	Carnobacteriaceae
Jeotgalibacillus	Planococcaceae
Jeotgalicoccus	Staphylococcaceae
Jhaorihella	Rhodobacteraceae
Jiangella	Jiangellaceae
Jiella	Aurantimonadaceae
Jishengella	Micromonosporaceae
Johnsonella	Lachnospiraceae
Jonesia	Jonesiaceae
Jonquetella	Synergistaceae
Joostella	Flavobacteriaceae
Kaistia	Rhizobiaceae
Kallotenue	Unclassified_Chloroflexales
Kandleria	Erysipelotrichaceae
Kangiella	Alcanivoracaceae
Kerstersia	Alcaligenaceae
Ketogulonicigenium	Rhodobacteraceae
Kibdelosporangium	Pseudonocardiaceae
Kiloniella	Kiloniellaceae
Kineococcus	Kineosporiaceae
Kineosphaera	Dermatophilaceae
Kineosporia	Kineosporiaceae
Kingella	Neisseriaceae
Kinneretia	Comamonadaceae
Kistimonas	Hahellaceae
Kitasatospora	Streptomycetaceae
Klebsiella	Enterobacteriaceae
Klebsiellaquasipneumoniae	Enterobacteriaceae
Klugiella	Microbacteriaceae
Kluyvera	Enterobacteriaceae
Knoellia	Intrasporangiaceae
Kocuria	Micrococcaceae
Kofleria	Kofleriaceae
Komagataeibacter	Acetobacteraceae
Kordia	Flavobacteriaceae
Kordiimonas	Kordiimonadaceae
Kosakonia	Enterobacteriaceae
Kosmotoga	Kosmotogaceae
Kozakia	Acetobacteraceae
Krasilnikovia	Micromonosporaceae
Kribbella	Nocardioidaceae
Kribbia	Intrasporangiaceae
Kriegella	Flavobacteriaceae
Kroppenstedtia	Thermoactinomycetaceae
Ktedonobacter	Ktedonobacteraceae
Kurthia	Planococcaceae
Kushneria	Halomonadaceae
Kutzneria	Pseudonocardiaceae
Kyrpidia	Alicyclobacillaceae
Kytococcus	Dermacoccaceae
Labedaea	Pseudonocardiaceae
Labedella	Microbacteriaceae
Labilithrix	Labilitrichaceae
Labrenzia	Rhodobacteraceae
Labrys	Xanthobacteraceae
Laceyella	Thermoactinomycetaceae
Lachnoanaerobaculum	Lachnospiraceae
Lachnobacterium	Lachnospiraceae
Lachnospira	Lachnospiraceae
Lacibacter	Chitinophagaceae
Lacibacterium	Rhodospirillaceae
Lacihabitans	Cytophagaceae
Lacinutrix	Flavobacteriaceae
Lacticigenium	Carnobacteriaceae
Lactivibrio	Synergistaceae
Lactobacillus	Lactobacillaceae
Lactococcus	Streptococcaceae
Lactonifactor	Clostridiaceae
Lactovum	Streptococcaceae
Lamprocystis	Chromatiaceae
Lampropedia	Comamonadaceae
Lapillicoccus	Intrasporangiaceae
Laribacter	Neisseriaceae
Larkinella	Cytophagaceae
Larsenimonas	Halomonadaceae
Lautropia	Burkholderiaceae
Lawsonia	Desulfovibrionaceae
Leadbetterella	Cytophagaceae
Lebetimonas	Nautiliaceae
Lechevalieria	Pseudonocardiaceae
Leeia	Neisseriaceae
Leeuwenhoekiella	Flavobacteriaceae
Legionella	Legionellaceae
Leifsonia	Microbacteriaceae
Leisingera	Rhodobacteraceae
Lelliottia	Enterobacteriaceae
Leminorella	Enterobacteriaceae
Lentibacillus	Bacillaceae
Lentibacter	Rhodobacteraceae
Lentilitoribacter	Phyllobacteriaceae
Lentisphaera	Lentisphaeraceae
Lentzea	Pseudonocardiaceae
Leptobacterium	Flavobacteriaceae
Leptolinea	Anaerolineaceae
Leptonema	Leptospiraceae
Leptospira	Leptospiraceae
Leptospirillum	Nitrospiraceae
Leptothrix	Unclassified_Burkholderiales
Leptotrichia	Leptotrichiaceae
Leucobacter	Microbacteriaceae
Leuconostoc	Leuconostocaceae
Leucothrix	Thiotrichaceae
Levilinea	Anaerolineaceae
Lewinella	Saprospiraceae
Lihuaxuella	Thermoactinomycetaceae
Limibacter	Flammeovirgaceae
Limimonas	Rhodospirillaceae
Limisphaera	Unclassified_Spartobacteria
Limnobacter	Burkholderiaceae
Limnohabitans	Comamonadaceae
Lishizhenia	Cryomorphaceae
Listeria	Listeriaceae
Litoreibacter	Rhodobacteraceae
Litoribacillus	Litoricolaceae
Litoribacter	Cytophagaceae
Litoribaculum	Flavobacteriaceae
Litoricola	Litoricolaceae
Litorilinea	Caldilineaceae
Litorimicrobium	Rhodobacteraceae
Litorimonas	Hyphomonadaceae
Litorisediminicola	Rhodobacteraceae
Litorivivens	Unclassified_Gammaproteobacteria
Loktanella	Rhodobacteraceae
Lonepinella	Pasteurellaceae
Longilinea	Anaerolineaceae
Longimycelium	Pseudonocardiaceae
Longispora	Micromonosporaceae
Lonsdalea	Enterobacteriaceae
Loriellopsis	Stigonematales
Luedemannella	Micromonosporaceae
Lunatimonas	Cyclobacteriaceae
Lutaonella	Flavobacteriaceae
Luteibacter	Rhodanobacteraceae
Luteibaculum	Cryomorphaceae
Luteimicrobium	Unclassified_Micrococcineae
Luteimonas	Lysobacteraceae
Luteipulveratus	Dermacoccaceae
Luteivirga	Unclassified_Cytophagales
Luteococcus	Propionibacteriaceae
Luteolibacter	Verrucomicrobiaceae
Lutibacter	Flavobacteriaceae
Lutibaculum	Rhodobiaceae
Lutimaribacter	Rhodobacteraceae
Lutimonas	Flavobacteriaceae
Lutispora	Clostridiaceae
Lysinibacillus	Bacillaceae
Lysinimicrobium	Demequinaceae
Lysinimonas	Microbacteriaceae
Lysobacter	Lysobacteraceae
Macellibacteroides	Porphyromonadaceae
Macrococcus	Staphylococcaceae
Macromonas	Comamonadaceae
Magnetococcus	Magnetococcaceae
Magnetospira	Rhodospirillaceae
Magnetospirillum	Rhodospirillaceae
Magnetovibrio	Rhodospirillaceae
Mahella	Unclassified_Thermoanaerobacterales
Malikia	Comamonadaceae
Malonomonas	Desulfuromonadaceae
Mameliella	Rhodobacteraceae
Mangrovibacter	Enterobacteriaceae
Mangrovibacterium	Prolixibacteraceae
Mangroviflexus	Marinilabiliaceae
Mangrovimonas	Flavobacteriaceae
Mannheimia	Pasteurellaceae
Maribacter	Flavobacteriaceae
Maribius	Rhodobacteraceae
Maricaulis	Hyphomonadaceae
Marichromatium	Chromatiaceae
Maricurvus	Unclassified_Alteromonadales
Marihabitans	Intrasporangiaceae
Marinactinospora	Nocardiopsaceae
Marinicauda	Hyphomonadaceae
Marinicella	Unclassified_Gammaproteobacteria
Marinifilum	Marinifilaceae
Mariniflexile	Flavobacteriaceae
Marinilabilia	Marinilabiliaceae
Marinilactibacillus	Carnobacteriaceae
Mariniluteicoccus	Propionibacteriaceae
Marinimicrobium	Alteromonadaceae
Marininema	Thermoactinomycetaceae
Mariniphaga	Prolixibacteraceae
Mariniradius	Cyclobacteriaceae
Marinithermus	Thermaceae
Marinitoga	Thermotogaceae
Marinobacter	Alteromonadaceae
Marinobacterium	Alteromonadaceae
Marinococcus	Bacillaceae
Marinomonas	Oceanospirillaceae
Marinoscillum	Flammeovirgaceae
Marinospirillum	Oceanospirillaceae
Marinovum	Rhodobacteraceae
Mariprofundus	Mariprofundaceae
Marisediminicola	Microbacteriaceae
Marispirillum	Rhodospirillaceae
Maritalea	Hyphomicrobiaceae
Maritimibacter	Rhodobacteraceae
Maritimimonas	Flavobacteriaceae
Marivirga	Flammeovirgaceae
Marivita	Rhodobacteraceae
Marixanthomonas	Flavobacteriaceae
Marmoricola	Nocardioidaceae
Martelella	Aurantimonadaceae
Marvinbryantia	Lachnospiraceae
Massilia	Oxalobacteraceae
Mechercharimyces	Thermoactinomycetaceae
Megamonas	Veillonellaceae
Meganema	Methylobacteriaceae
Megasphaera	Veillonellaceae
Meiothermus	Thermaceae
Melaminivora	Comamonadaceae
Melghiribacillus	Bacillaceae
Melghirimyces	Thermoactinomycetaceae
Melioribacter	Melioribacteraceae
Melissococcus	Enterococcaceae
Melittangium	Cystobacteraceae
Meniscus	Cytophagaceae
Meridianimaribacter	Flavobacteriaceae
Mesoaciditoga	Thermotogaceae
Mesocricetibacter	Pasteurellaceae
Mesoflavibacter	Flavobacteriaceae
Mesonia	Flavobacteriaceae
Mesoplasma	Entomoplasmataceae
Mesorhizobium	Phyllobacteriaceae
Mesotoga	Thermotogaceae
Metallibacterium	Lysobacteraceae
Metallosphaera	Sulfolobaceae
Methanimicrococcus	Methanosarcinaceae
Methanobacterium	Methanobacteriaceae
Methanobrevibacter	Methanobacteriaceae
Methanocalculus	Unclassified_Methanomicrobiales
Methanocaldococcus	Methanocaldococcaceae
Methanocella	Methanocellaceae
Methanococcoides	Methanosarcinaceae
Methanococcus	Methanococcaceae
Methanocorpusculum	Methanocorpusculaceae
Methanoculleus	Methanomicrobiaceae
Methanofollis	Methanomicrobiaceae
Methanogenium	Methanomicrobiaceae
Methanohalobium	Methanosarcinaceae
Methanohalophilus	Methanosarcinaceae
Methanolacinia	Methanomicrobiaceae
Methanolinea	Methanoregulaceae
Methanolobus	Methanosarcinaceae
Methanomassiliicoccus	Methanomassiliicoccaceae
Methanomethylovorans	Methanosarcinaceae
Methanomicrobium	Methanomicrobiaceae
Methanoplanus	Methanomicrobiaceae
Methanopyrus	Methanopyraceae
Methanoregula	Methanoregulaceae
Methanosalsum	Methanosarcinaceae
Methanosarcina	Methanosarcinaceae
Methanosphaera	Methanobacteriaceae
Methanosphaerula	Methanoregulaceae
Methanospirillum	Methanospirillaceae
Methanothermobacter	Methanobacteriaceae
Methanothermococcus	Methanococcaceae
Methanothermus	Methanothermaceae
Methanothrix	Methanotrichaceae
Methanotorris	Methanocaldococcaceae
Methermicoccus	Methermicoccaceae
Methylarcula	Rhodobacteraceae
Methylibium	Unclassified_Burkholderiales
Methylobacillus	Methylophilaceae
Methylobacter	Methylococcaceae
Methylobacterium	Methylobacteriaceae
Methylobrevis	Unclassified_Rhizobiales
Methylocaldum	Methylococcaceae
Methylocapsa	Beijerinckiaceae
Methyloceanibacter	Rhodobiaceae
Methylocella	Beijerinckiaceae
Methylococcus	Methylococcaceae
Methylocystis	Methylocystaceae
Methyloferula	Beijerinckiaceae
Methylogaea	Methylococcaceae
Methylohalobius	Methylococcaceae
Methylohalomonas	Unclassified_Gammaproteobacteria
Methyloligella	Rhodobiaceae
Methylomarinovum	Methylococcaceae
Methylomarinum	Methylococcaceae
Methylomicrobium	Methylococcaceae
Methylomonas	Methylococcaceae
Methylonatrum	Unclassified_Gammaproteobacteria
Methyloparacoccus	Methylococcaceae
Methylophaga	Piscirickettsiaceae
Methylophilus	Methylophilaceae
Methylopila	Methylocystaceae
Methyloprofundus	Methylococcaceae
Methylorhabdus	Hyphomicrobiaceae
Methylorosula	Beijerinckiaceae
Methylosarcina	Methylococcaceae
Methylosinus	Methylocystaceae
Methylosoma	Methylococcaceae
Methylosphaera	Methylococcaceae
Methylotenera	Methylophilaceae
Methylothermus	Methylothermaceae
Methyloversatilis	Rhodocyclaceae
Methylovirgula	Beijerinckiaceae
Methylovorus	Methylophilaceae
Methylovulum	Methylococcaceae
Microaerobacter	Bacillaceae
Microbacter	Porphyromonadaceae
Microbacterium	Microbacteriaceae
Microbispora	Streptosporangiaceae
Microbulbifer	Alteromonadaceae
Microcella	Microbacteriaceae
Micrococcus	Micrococcaceae
Microlunatus	Propionibacteriaceae
Micromonospora	Micromonosporaceae
Micropolyspora	Nocardiaceae
Micropruina	Propionibacteriaceae
Microscilla	Cytophagaceae
Microterricola	Microbacteriaceae
Microtetraspora	Streptosporangiaceae
Microvirga	Methylobacteriaceae
Microvirgula	Neisseriaceae
Millisia	Nocardiaceae
Minicystis	Polyangiaceae
Miniimonas	Beutenbergiaceae
Mitsuaria	Unclassified_Burkholderiales
Mitsuokella	Veillonellaceae
Mizugakilibacter	Lysobacteraceae
Mobilicoccus	Dermatophilaceae
Mobilitalea	Clostridiaceae
Mobiluncus	Actinomycetaceae
Modestobacter	Geodermatophilaceae
Modicisalibacter	Halomonadaceae
Mogibacterium	Unclassified_Clostridiales
Moheibacter	Flavobacteriaceae
Mongoliicoccus	Cyclobacteriaceae
Mongoliitalea	Cyclobacteriaceae
Mooreia	Mooreiaceae
Moorella	Thermoanaerobacteraceae
Moraxella	Moraxellaceae
Morganella	Enterobacteriaceae
Moritella	Moritellaceae
Moryella	Lachnospiraceae
Motilibacter	Motilibacteraceae
Motiliproteus	Oceanospirillaceae
Mucilaginibacter	Sphingobacteriaceae
Mucinivorans	Rikenellaceae
Mucispirillum	Deferribacteraceae
Mumia	Nocardioidaceae
Murdochiella	Unclassified_Clostridiales
Muricauda	Flavobacteriaceae
Muriicola	Flavobacteriaceae
Murimonas	Lachnospiraceae
Murinocardiopsis	Nocardiopsaceae
Myceligenerans	Promicromonosporaceae
Mycetocola	Microbacteriaceae
Mycobacterium	Mycobacteriaceae
Mycoplana	Brucellaceae
Mycoplasma	Mycoplasmataceae
Myroides	Flavobacteriaceae
Myxococcus	Myxococcaceae
Naasia	Microbacteriaceae
Nafulsella	Flammeovirgaceae
Nakamurella	Nakamurellaceae
Namhaeicola	Flavobacteriaceae
Nannocystis	Nannocystaceae
Natranaerobaculum	Natranaerobiaceae
Natranaerobius	Natranaerobiaceae
Natranaerovirga	Unclassified_Clostridiales
Natrialba	Natrialbaceae
Natribacillus	Bacillaceae
Natribaculum	Halobacteriaceae
Natrinema	Natrialbaceae
Natroniella	Halobacteroidaceae
Natronincola	Clostridiaceae
Natronoarchaeum	Halobacteriaceae
Natronobacillus	Bacillaceae
Natronobacterium	Natrialbaceae
Natronocella	Ectothiorhodospiraceae
Natronococcus	Natrialbaceae
Natronoflexus	Marinilabiliaceae
Natronolimnobius	Natrialbaceae
Natronomonas	Halobacteriaceae
Natronorubrum	Natrialbaceae
Natronovirga	Natranaerobiaceae
Naumannella	Propionibacteriaceae
Nautella	Rhodobacteraceae
Nautilia	Nautiliaceae
Necropsobacter	Pasteurellaceae
Negativicoccus	Veillonellaceae
Neiella	Unclassified_Alteromonadales
Neisseria	Neisseriaceae
Neoasaia	Acetobacteraceae
Neochlamydia	Parachlamydiaceae
Neokomagataea	Acetobacteraceae
Neorhizobium	Rhizobiaceae
Neorickettsia	Anaplasmataceae
Neptuniibacter	Oceanospirillaceae
Neptunomonas	Oceanospirillaceae
Nereida	Rhodobacteraceae
Nesiotobacter	Rhodobacteraceae
Nesterenkonia	Micrococcaceae
Nevskia	Nevskiaceae
Nguyenibacter	Acetobacteraceae
Niabella	Chitinophagaceae
Niastella	Chitinophagaceae
Nibrella	Cytophagaceae
Nibribacter	Cytophagaceae
Nicoletella	Pasteurellaceae
Nioella	Rhodobacteraceae
Nisaea	Rhodospirillaceae
Nitratifractor	Nautiliaceae
Nitratireductor	Phyllobacteriaceae
Nitratiruptor	Nautiliaceae
Nitriliruptor	Nitriliruptoraceae
Nitrincola	Oceanospirillaceae
Nitritalea	Cyclobacteriaceae
Nitrobacter	Bradyrhizobiaceae
Nitrococcus	Ectothiorhodospiraceae
Nitrolancea	Sphaerobacteraceae
Nitrosococcus	Chromatiaceae
Nitrosomonas	Nitrosomonadaceae
Nitrososphaera	Nitrososphaeraceae
Nitrosospira	Nitrosomonadaceae
Nitrospirillum	Rhodospirillaceae
Niveispirillum	Rhodospirillaceae
Nocardia	Nocardiaceae
Nocardioides	Nocardioidaceae
Nocardiopsis	Nocardiopsaceae
Nonlabens	Flavobacteriaceae
Nonomuraea	Streptosporangiaceae
Nosocomiicoccus	Staphylococcaceae
Noviherbaspirillum	Oxalobacteraceae
Novispirillum	Rhodospirillaceae
Novosphingobium	Sphingomonadaceae
Nubsella	Sphingobacteriaceae
Obesumbacterium	Enterobacteriaceae
Oceanibacterium	Sneathiellaceae
Oceanibaculum	Rhodospirillaceae
Oceanibulbus	Rhodobacteraceae
Oceanicaulis	Hyphomonadaceae
Oceanicella	Rhodobacteraceae
Oceanicola	Rhodobacteraceae
Oceanimonas	Aeromonadaceae
Oceanirhabdus	Clostridiaceae
Oceaniserpentilla	Oceanospirillaceae
Oceanisphaera	Aeromonadaceae
Oceanitalea	Bogoriellaceae
Oceanithermus	Thermaceae
Oceanobacillus	Bacillaceae
Oceanobacter	Oceanospirillaceae
Oceanococcus	Ectothiorhodospiraceae
Oceanospirillum	Oceanospirillaceae
Oceanotoga	Thermotogaceae
Ochrobactrum	Brucellaceae
Octadecabacter	Rhodobacteraceae
Odoribacter	Porphyromonadaceae
Oenococcus	Leuconostocaceae
Oerskovia	Cellulomonadaceae
Ohtaekwangia	Unclassified_Cytophagales
Okibacterium	Microbacteriaceae
Oleiagrimonas	Lysobacteraceae
Oleibacter	Oceanospirillaceae
Oleiphilus	Oleiphilaceae
Oleispira	Oceanospirillaceae
Oligella	Alcaligenaceae
Oligoflexus	Oligoflexaceae
Oligosphaera	Oligosphaeraceae
Oligotropha	Bradyrhizobiaceae
Olivibacter	Sphingobacteriaceae
Olleya	Flavobacteriaceae
Olsenella	Atopobacteriaceae
Opitutus	Opitutaceae
Orbus	Orbaceae
Orenia	Halobacteroidaceae
Oribacterium	Lachnospiraceae
Orientia	Rickettsiaceae
Ornatilinea	Anaerolineaceae
Ornithinibacillus	Bacillaceae
Ornithinibacter	Intrasporangiaceae
Ornithinicoccus	Intrasporangiaceae
Ornithinimicrobium	Intrasporangiaceae
Ornithobacterium	Flavobacteriaceae
Oryzihumus	Intrasporangiaceae
Oscillibacter	Oscillospiraceae
Otariodibacter	Pasteurellaceae
Ottowia	Comamonadaceae
Owenweeksia	Cryomorphaceae
Oxalicibacterium	Oxalobacteraceae
Oxalobacter	Oxalobacteraceae
Oxalophagus	Paenibacillaceae
Oxobacter	Clostridiaceae
Pacificibacter	Rhodobacteraceae
Paenalcaligenes	Alcaligenaceae
Paenibacillus	Paenibacillaceae
Paenirhodobacter	Rhodobacteraceae
Paenisporosarcina	Planococcaceae
Paenochrobactrum	Brucellaceae
Palaeococcus	Thermococcaceae
Palleronia	Rhodobacteraceae
Paludibacter	Porphyromonadaceae
Paludibacterium	Neisseriaceae
Paludibaculum	Unclassified_Acidobacteria
Panacagrimonas	Lysobacteraceae
Pandoraea	Burkholderiaceae
Pannonibacter	Rhodobacteraceae
Pantanalinema	Oscillatoriales
Pantoea	Enterobacteriaceae
Papillibacter	Ruminococcaceae
Parabacteroides	Porphyromonadaceae
Parablastomonas	Sphingomonadaceae
Parachlamydia	Parachlamydiaceae
Paracoccus	Rhodobacteraceae
Paracraurococcus	Acetobacteraceae
Paraeggerthella	Eggerthellaceae
Paraferrimonas	Ferrimonadaceae
Parafilimonas	Chitinophagaceae
Paraglaciecola	Alteromonadaceae
Paraherbaspirillum	Oxalobacteraceae
Paralactobacillus	Lactobacillaceae
Paralcaligenes	Alcaligenaceae
Paraliobacillus	Bacillaceae
Paramoritella	Moritellaceae
Paraoerskovia	Cellulomonadaceae
Parapedobacter	Sphingobacteriaceae
Paraperlucidibaca	Moraxellaceae
Paraprevotella	Prevotellaceae
Parapusillimonas	Alcaligenaceae
Pararhodospirillum	Rhodospirillaceae
Parascardovia	Bifidobacteriaceae
Parasegetibacter	Chitinophagaceae
Parasphingopyxis	Sphingomonadaceae
Parasporobacterium	Lachnospiraceae
Parasutterella	Sutterellaceae
Parvibacter	Eggerthellaceae
Parvibaculum	Rhodobiaceae
Parvimonas	Unclassified_Clostridiales
Parvularcula	Parvularculaceae
Pasteurella	Pasteurellaceae
Patulibacter	Patulibacteraceae
Paucibacter	Unclassified_Burkholderiales
Paucimonas	Burkholderiaceae
Paucisalibacillus	Bacillaceae
Pectinatus	Veillonellaceae
Pectobacterium	Enterobacteriaceae
Pediococcus	Lactobacillaceae
Pedobacter	Sphingobacteriaceae
Pedomicrobium	Hyphomicrobiaceae
Pelagibaca	Rhodobacteraceae
Pelagibacterium	Hyphomicrobiaceae
Pelagibius	Rhodospirillaceae
Pelagicoccus	Puniceicoccaceae
Pelagicola	Rhodobacteraceae
Pelagimonas	Rhodobacteraceae
Pelistega	Alcaligenaceae
Pelobacter	Desulfuromonadaceae
Pelolinea	Anaerolineaceae
Pelomonas	Comamonadaceae
Pelosinus	Veillonellaceae
Pelospora	Syntrophomonadaceae
Pelotomaculum	Peptococcaceae
Peptococcus	Peptococcaceae
Peptoniphilus	Peptoniphilaceae
Peptostreptococcus	Peptostreptococcaceae
Peredibacter	Bacteriovoracaceae
Perexilibacter	Flammeovirgaceae
Perlucidibaca	Moraxellaceae
Permianibacter	Pseudomonadaceae
Persephonella	Hydrogenothermaceae
Persicirhabdus	Verrucomicrobiaceae
Persicitalea	Cytophagaceae
Persicobacter	Flammeovirgaceae
Perspicuibacter	Arenicellaceae
Petrimonas	Porphyromonadaceae
Petrotoga	Petrotogaceae
Phaeobacter	Rhodobacteraceae
Phaeochromatium	Chromatiaceae
Phaeocystidibacter	Cryomorphaceae
Phaeodactylibacter	Saprospiraceae
Phaeospirillum	Rhodospirillaceae
Phaeovibrio	Rhodospirillaceae
Phascolarctobacterium	Acidaminococcaceae
Phaselicystis	Phaselicystidaceae
Phaseolibacter	Enterobacteriaceae
Phenylobacterium	Caulobacteraceae
Phocaeicola	Unclassified_Bacteroidales
Phocoenobacter	Pasteurellaceae
Phorcysia	Desulfurobacteriaceae
Photobacterium	Vibrionaceae
Photorhabdus	Enterobacteriaceae
Phreatobacter	Unclassified_Alphaproteobacteria
Phycicoccus	Intrasporangiaceae
Phycicola	Microbacteriaceae
Phycisphaera	Phycisphaeraceae
Phyllobacterium	Phyllobacteriaceae
Phytohabitans	Micromonosporaceae
Phytomonospora	Micromonosporaceae
Pibocella	Flavobacteriaceae
Picrophilus	Picrophilaceae
Pigmentiphaga	Alcaligenaceae
Pilibacter	Enterococcaceae
Pilimelia	Micromonosporaceae
Pimelobacter	Nocardioidaceae
Pirellula	Planctomycetaceae
Piscibacillus	Bacillaceae
Piscicoccus	Dermatophilaceae
Pisciglobus	Carnobacteriaceae
Piscinibacter	Unclassified_Burkholderiales
Piscirickettsia	Piscirickettsiaceae
Planctomicrobium	Planctomycetaceae
Planctopirus	Planctomycetaceae
Planifilum	Thermoactinomycetaceae
Planktomarina	Rhodobacteraceae
Planktotalea	Rhodobacteraceae
Planktothricoides	Oscillatoriales
Planobispora	Streptosporangiaceae
Planococcus	Planococcaceae
Planomicrobium	Planococcaceae
Planomonospora	Streptosporangiaceae
Planosporangium	Micromonosporaceae
Planotetraspora	Streptosporangiaceae
Plantactinospora	Micromonosporaceae
Plantibacter	Microbacteriaceae
Plasticicumulans	Unclassified_Gammaproteobacteria
Pleionea	Unclassified_Gammaproteobacteria
Pleomorphobacterium	Rhodobacteraceae
Pleomorphomonas	Methylocystaceae
Plesiocystis	Nannocystaceae
Plesiomonas	Enterobacteriaceae
Pluralibacter	Enterobacteriaceae
Polaribacter	Flavobacteriaceae
Polaromonas	Comamonadaceae
Polyangium	Polyangiaceae
Polycladomyces	Thermoactinomycetaceae
Polymorphobacter	Sphingomonadaceae
Polymorphospora	Micromonosporaceae
Polynucleobacter	Burkholderiaceae
Pontibaca	Rhodobacteraceae
Pontibacillus	Bacillaceae
Pontibacter	Cytophagaceae
Ponticaulis	Hyphomonadaceae
Ponticoccus	Rhodobacteraceae
Pontimonas	Microbacteriaceae
Porphyrobacter	Erythrobacteraceae
Porphyromonas	Porphyromonadaceae
Portibacter	Saprospiraceae
Porticoccus	Unclassified_Gammaproteobacteria
Poseidonocella	Rhodobacteraceae
Postechiella	Flavobacteriaceae
Povalibacter	Unclassified_Lysobacteriales
Pragia	Enterobacteriaceae
Prauserella	Pseudonocardiaceae
Prevotella	Prevotellaceae
Pricia	Flavobacteriaceae
Primorskyibacter	Rhodobacteraceae
Prochlorococcus	Prochlorococcaceae
Prochlorothrix	Prochlorotrichaceae
Profundibacterium	Rhodobacteraceae
Prolixibacter	Prolixibacteraceae
Promicromonospora	Promicromonosporaceae
Propionibacterium	Propionibacteriaceae
Propionicicella	Propionibacteriaceae
Propioniciclava	Propionibacteriaceae
Propionicimonas	Propionibacteriaceae
Propioniferax	Propionibacteriaceae
Propionigenium	Fusobacteriaceae
Propionimicrobium	Propionibacteriaceae
Propionispira	Veillonellaceae
Propionispora	Veillonellaceae
Propionivibrio	Rhodocyclaceae
Prosthecobacter	Verrucomicrobiaceae
Prosthecochloris	Chlorobiaceae
Prosthecomicrobium	Hyphomicrobiaceae
Proteiniborus	Unclassified_Clostridiales
Proteiniclasticum	Clostridiaceae
Proteiniphilum	Porphyromonadaceae
Proteinivorax	Unclassified_Clostridiales
Proteocatella	Unclassified_Clostridiales
Proteus	Enterobacteriaceae
Providencia	Enterobacteriaceae
Pseudacidovorax	Comamonadaceae
Pseudahrensia	Phyllobacteriaceae
Pseudaminobacter	Phyllobacteriaceae
Pseudarcicella	Cytophagaceae
Pseudenhygromyxa	Nannocystaceae
Pseudidiomarina	Idiomarinaceae
Pseudoalteromonas	Pseudoalteromonadaceae
Pseudobacteriovorax	Pseudobacteriovoracaceae
Pseudobacteroides	Ruminococcaceae
Pseudobutyrivibrio	Lachnospiraceae
Pseudochelatococcus	Unclassified_Alphaproteobacteria
Pseudochrobactrum	Brucellaceae
Pseudocitrobacter	Enterobacteriaceae
Pseudoclavibacter	Microbacteriaceae
Pseudodonghicola	Rhodobacteraceae
Pseudoduganella	Oxalobacteraceae
Pseudoflavonifractor	Unclassified_Clostridiales
Pseudofulvibacter	Flavobacteriaceae
Pseudofulvimonas	Rhodanobacteraceae
Pseudogulbenkiania	Neisseriaceae
Pseudohalocynthiibacter	Rhodobacteraceae
Pseudohongiella	Alcanivoracaceae
Pseudokineococcus	Kineosporiaceae
Pseudolabrys	Xanthobacteraceae
Pseudomaricurvus	Unclassified_Alteromonadales
Pseudomonas	Pseudomonadaceae
Pseudonocardia	Pseudonocardiaceae
Pseudopedobacter	Sphingobacteriaceae
Pseudopelagicola	Rhodobacteraceae
Pseudophaeobacter	Rhodobacteraceae
Pseudoramibacter	Eubacteriaceae
Pseudorhodobacter	Rhodobacteraceae
Pseudorhodoferax	Comamonadaceae
Pseudoruegeria	Rhodobacteraceae
Pseudoscardovia	Bifidobacteriaceae
Pseudosphingobacterium	Sphingobacteriaceae
Pseudospirillum	Oceanospirillaceae
Pseudosporangium	Micromonosporaceae
Pseudoteredinibacter	Unclassified_Alteromonadales
Pseudothermotoga	Thermotogaceae
Pseudovibrio	Rhodobacteraceae
Pseudoxanthobacter	Xanthobacteraceae
Pseudoxanthomonas	Lysobacteraceae
Pseudozobellia	Flavobacteriaceae
Psychrilyobacter	Fusobacteriaceae
Psychrobacillus	Bacillaceae
Psychrobacter	Moraxellaceae
Psychrobium	Unclassified_Alteromonadales
Psychroflexus	Flavobacteriaceae
Psychroglaciecola	Methylobacteriaceae
Psychromonas	Psychromonadaceae
Psychroserpens	Flavobacteriaceae
Psychrosphaera	Pseudoalteromonadaceae
Pullulanibacillus	Sporolactobacillaceae
Puniceibacterium	Rhodobacteraceae
Puniceicoccus	Puniceicoccaceae
Pusillimonas	Alcaligenaceae
Pustulibacterium	Flavobacteriaceae
Pyramidobacter	Synergistaceae
Pyrinomonas	Unclassified_Elusimicrobia
Pyrobaculum	Thermoproteaceae
Pyrococcus	Thermococcaceae
Pyrodictium	Pyrodictiaceae
Pyxidicoccus	Myxococcaceae
Quadrisphaera	Kineosporiaceae
Quatrionicoccus	Rhodocyclaceae
Rahnella	Enterobacteriaceae
Ralstonia	Burkholderiaceae
Ramlibacter	Comamonadaceae
Raoultella	Enterobacteriaceae
Rapidithrix	Flammeovirgaceae
Rarobacter	Rarobacteraceae
Rathayibacter	Microbacteriaceae
Rehaibacterium	Lysobacteraceae
Reichenbachiella	Flammeovirgaceae
Reinekea	Oceanospirillaceae
Renibacterium	Micrococcaceae
Reyranella	Unclassified_Rhodospirillales
Rhabdochromatium	Chromatiaceae
Rhabdothermus	Thermaceae
Rheinheimera	Chromatiaceae
Rhizobacter	Pseudomonadaceae
Rhizobium	Rhizobiaceae
Rhizocola	Micromonosporaceae
Rhizomicrobium	Unclassified_Alphaproteobacteria
Rhizorhabdus	Sphingomonadaceae
Rhizorhapis	Sphingomonadaceae
Rhodanobacter	Rhodanobacteraceae
Rhodobaca	Rhodobacteraceae
Rhodobacter	Rhodobacteraceae
Rhodobium	Rhodobiaceae
Rhodoblastus	Bradyrhizobiaceae
Rhodocista	Rhodospirillaceae
Rhodococcus	Nocardiaceae
Rhodocyclus	Rhodocyclaceae
Rhodocytophaga	Cytophagaceae
Rhodoferax	Comamonadaceae
Rhodoglobus	Microbacteriaceae
Rhodoligotrophos	Rhodobiaceae
Rhodoluna	Microbacteriaceae
Rhodomicrobium	Hyphomicrobiaceae
Rhodonellum	Cytophagaceae
Rhodopila	Acetobacteraceae
Rhodopirellula	Planctomycetaceae
Rhodoplanes	Hyphomicrobiaceae
Rhodopseudomonas	Bradyrhizobiaceae
Rhodospira	Rhodospirillaceae
Rhodospirillum	Rhodospirillaceae
Rhodothalassium	Rhodothalassiaceae
Rhodothermus	Rhodothermaceae
Rhodovarius	Acetobacteraceae
Rhodovibrio	Rhodospirillaceae
Rhodovulum	Rhodobacteraceae
Rickettsia	Rickettsiaceae
Riemerella	Flavobacteriaceae
Rikenella	Rikenellaceae
Rivibacter	Unclassified_Burkholderiales
Rivicola	Neisseriaceae
Robertkochia	Flavobacteriaceae
Robiginitalea	Flavobacteriaceae
Robiginitomaculum	Hyphomonadaceae
Robinsoniella	Lachnospiraceae
Romboutsia	Clostridiaceae
Roseateles	Comamonadaceae
Roseburia	Lachnospiraceae
Roseiarcus	Roseiarcaceae
Roseibaca	Rhodobacteraceae
Roseibacillus	Verrucomicrobiaceae
Roseibacterium	Rhodobacteraceae
Roseibium	Rhodobacteraceae
Roseicitreum	Rhodobacteraceae
Roseicyclus	Rhodobacteraceae
Roseiflexus	Roseiflexaceae
Roseimicrobium	Verrucomicrobiaceae
Roseinatronobacter	Rhodobacteraceae
Roseisalinus	Rhodobacteraceae
Roseivirga	Flammeovirgaceae
Roseivivax	Rhodobacteraceae
Rosenbergiella	Enterobacteriaceae
Roseobacter	Rhodobacteraceae
Roseococcus	Acetobacteraceae
Roseomonas	Acetobacteraceae
Roseospira	Rhodospirillaceae
Roseospirillum	Rhodobiaceae
Roseovarius	Rhodobacteraceae
Rothia	Micrococcaceae
Ruania	Ruaniaceae
Rubellimicrobium	Rhodobacteraceae
Rubidibacter	Chroococcales
Rubinisphaera	Planctomycetaceae
Rubribacterium	Rhodobacteraceae
Rubricoccus	Rhodothermaceae
Rubrimonas	Rhodobacteraceae
Rubritalea	Rubritaleaceae
Rubritepida	Acetobacteraceae
Rubrivirga	Cytophagales
Rubrivivax	Unclassified_Burkholderiales
Rubrobacter	Rubrobacteraceae
Rudaea	Rhodanobacteraceae
Rudaeicoccus	Dermacoccaceae
Rudaibacter	Microbacteriaceae
Rudanella	Cytophagaceae
Ruegeria	Rhodobacteraceae
Rufibacter	Cytophagaceae
Rugamonas	Pseudomonadaceae
Rugosimonospora	Micromonosporaceae
Ruminobacter	Succinivibrionaceae
Ruminococcus	Ruminococcaceae
Rummeliibacillus	Unclassified_Bacillales
Runella	Cytophagaceae
Sabulilitoribacter	Flavobacteriaceae
Saccharibacillus	Paenibacillaceae
Saccharibacter	Acetobacteraceae
Saccharicrinis	Unclassified_Bacteroidales
Saccharococcus	Bacillaceae
Saccharofermentans	Clostridiaceae
Saccharomonospora	Pseudonocardiaceae
Saccharophagus	Alteromonadaceae
Saccharopolyspora	Pseudonocardiaceae
Saccharospirillum	Saccharospirillaceae
Saccharothrix	Pseudonocardiaceae
Sagittula	Rhodobacteraceae
Salana	Beutenbergiaceae
Salarchaeum	Halobacteriaceae
Salegentibacter	Flavobacteriaceae
Salicola	Unclassified_Oceanospirillales
Salimesophilobacter	Clostridiaceae
Salimicrobium	Bacillaceae
Salinactinospora	Nocardiopsaceae
Salinarchaeum	Natrialbaceae
Salinarimonas	Bradyrhizobiaceae
Salinibacillus	Bacillaceae
Salinibacter	Rhodothermaceae
Salinibacterium	Microbacteriaceae
Salinicoccus	Staphylococcaceae
Salinicola	Halomonadaceae
Salinihabitans	Rhodobacteraceae
Salinimicrobium	Flavobacteriaceae
Salinimonas	Alteromonadaceae
Salinirepens	Cryomorphaceae
Salinirubrum	Halobacteriaceae
Salinisphaera	Salinisphaeraceae
Salinispira	Spirochaetaceae
Salinispirillum	Unclassified_Oceanospirillales
Salinispora	Micromonosporaceae
Salinithrix	Thermoactinomycetaceae
Salinivibrio	Vibrionaceae
Salipiger	Rhodobacteraceae
Salirhabdus	Bacillaceae
Salisaeta	Rhodothermaceae
Salisediminibacterium	Bacillaceae
Saliterribacillus	Bacillaceae
Salmonella	Enterobacteriaceae
Salsuginibacillus	Bacillaceae
Samsonia	Enterobacteriaceae
Sandaracinobacter	Sphingomonadaceae
Sandaracinus	Sandaracinaceae
Sandarakinorhabdus	Sphingomonadaceae
Sanguibacter	Sanguibacteraceae
Sarcina	Clostridiaceae
Scardovia	Bifidobacteriaceae
Schlegelella	Comamonadaceae
Schleiferia	Schleiferiaceae
Schlesneria	Planctomycetaceae
Schumannella	Microbacteriaceae
Schwartzia	Veillonellaceae
Sciscionella	Pseudonocardiaceae
Sebaldella	Leptotrichiaceae
Sedimentibacter	Unclassified_Clostridiales
Sedimenticola	Unclassified_Gammaproteobacteria
Sedimentitalea	Rhodobacteraceae
Sediminibacillus	Bacillaceae
Sediminibacter	Flavobacteriaceae
Sediminibacterium	Chitinophagaceae
Sediminicola	Flavobacteriaceae
Sediminihabitans	Cellulomonadaceae
Sediminimonas	Rhodobacteraceae
Sediminitomix	Flammeovirgaceae
Segetibacter	Chitinophagaceae
Segniliparus	Segniliparaceae
Seinonella	Thermoactinomycetaceae
Selenihalanaerobacter	Halobacteroidaceae
Seleniivibrio	Deferribacteraceae
Selenomonas	Veillonellaceae
Seminibacterium	Pasteurellaceae
Senegalimassilia	Eggerthellaceae
Seohaeicola	Rhodobacteraceae
Seonamhaeicola	Flavobacteriaceae
Serinibacter	Beutenbergiaceae
Serinicoccus	Intrasporangiaceae
Serpens	Pseudomonadaceae
Serratia	Enterobacteriaceae
Sharpea	Lactobacillaceae
Shewanella	Shewanellaceae
Shigella	Enterobacteriaceae
Shimazuella	Thermoactinomycetaceae
Shimia	Rhodobacteraceae
Shimwellia	Enterobacteriaceae
Shinella	Rhizobiaceae
Shivajiella	Cyclobacteriaceae
Shuttleworthia	Lachnospiraceae
Siansivirga	Flavobacteriaceae
Siccibacter	Enterobacteriaceae
Silanimonas	Lysobacteraceae
Silicibacter	Rhodobacteraceae
Silvimonas	Neisseriaceae
Simiduia	Unclassified_Gammaproteobacteria
Simkania	Simkaniaceae
Simonsiella	Neisseriaceae
Simplicispira	Comamonadaceae
Singulisphaera	Planctomycetaceae
Sinibacillus	Bacillaceae
Sinobaca	Sporolactobacillaceae
Sinobacterium	Oceanospirillaceae
Sinomicrobium	Flavobacteriaceae
Sinomonas	Micrococcaceae
Sinosporangium	Unclassified_Streptosporangineae
Siphonobacter	Cytophagaceae
Skermanella	Rhodospirillaceae
Skermania	Nocardiaceae
Slackia	Eggerthellaceae
Smaragdicoccus	Nocardiaceae
Smithella	Syntrophaceae
Sneathia	Leptotrichiaceae
Sneathiella	Sneathiellaceae
Snodgrassella	Neisseriaceae
Snuella	Flavobacteriaceae
Sodalis	Enterobacteriaceae
Soehngenia	Unclassified_Clostridiales
Solibacillus	Unclassified_Bacillales
Solimonas	Nevskiaceae
Solirubrobacter	Solirubrobacteraceae
Solitalea	Sphingobacteriaceae
Solobacterium	Erysipelotrichaceae
Soonwooa	Flavobacteriaceae
Sorangium	Polyangiaceae
Spelaeicoccus	Brevibacteriaceae
Sphaerisporangium	Streptosporangiaceae
Sphaerobacter	Sphaerobacteraceae
Sphaerochaeta	Spirochaetaceae
Sphaerotilus	Unclassified_Burkholderiales
Sphingobacterium	Sphingobacteriaceae
Sphingobium	Sphingomonadaceae
Sphingomicrobium	Sphingomonadaceae
Sphingomonas	Sphingomonadaceae
Sphingopyxis	Sphingomonadaceae
Sphingorhabdus	Sphingomonadaceae
Sphingosinicella	Sphingomonadaceae
Spinactinospora	Nocardiopsaceae
Spiribacter	Ectothiorhodospiraceae
Spirilliplanes	Micromonosporaceae
Spirillospora	Thermomonosporaceae
Spirillum	Spirillaceae
Spirochaeta	Spirochaetaceae
Spiroplasma	Spiroplasmataceae
Spirosoma	Cytophagaceae
Spongiibacter	Unclassified_Gammaproteobacteria
Spongiibacterium	Flavobacteriaceae
Spongiimonas	Flavobacteriaceae
Spongiispira	Unclassified_Oceanospirillales
Spongiivirga	Flavobacteriaceae
Sporacetigenium	Peptostreptococcaceae
Sporanaerobacter	Unclassified_Clostridiales
Sporichthya	Sporichthyaceae
Sporobacter	Ruminococcaceae
Sporobacterium	Lachnospiraceae
Sporocytophaga	Cytophagaceae
Sporohalobacter	Halobacteroidaceae
Sporolactobacillus	Sporolactobacillaceae
Sporolituus	Veillonellaceae
Sporomusa	Veillonellaceae
Sporosalibacterium	Clostridiaceae
Sporosarcina	Planococcaceae
Sporotomaculum	Peptococcaceae
Stackebrandtia	Glycomycetaceae
Stakelama	Sphingomonadaceae
Staphylococcus	Staphylococcaceae
Staphylothermus	Desulfurococcaceae
Stappia	Rhodobacteraceae
Starkeya	Xanthobacteraceae
Stella	Acetobacteraceae
Stenotrophomonas	Lysobacteraceae
Stenoxybacter	Neisseriaceae
Steroidobacter	Nevskiaceae
Sterolibacterium	Rhodocyclaceae
Stetteria	Desulfurococcaceae
Stigmatella	Cystobacteraceae
Stomatobaculum	Lachnospiraceae
Streptacidiphilus	Streptomycetaceae
Streptoalloteichus	Pseudonocardiaceae
Streptobacillus	Leptotrichiaceae
Streptococcus	Streptococcaceae
Streptohalobacillus	Bacillaceae
Streptomonospora	Nocardiopsaceae
Streptomyces	Streptomycetaceae
Streptosporangium	Streptosporangiaceae
Stygiolobus	Sulfolobaceae
Subdoligranulum	Ruminococcaceae
Subsaxibacter	Flavobacteriaceae
Subsaximicrobium	Flavobacteriaceae
Subtercola	Microbacteriaceae
Succinatimonas	Succinivibrionaceae
Succiniclasticum	Acidaminococcaceae
Succinimonas	Succinivibrionaceae
Succinispira	Acidaminococcaceae
Succinivibrio	Succinivibrionaceae
Sulfitobacter	Rhodobacteraceae
Sulfobacillus	Unclassified_Clostridiales
Sulfolobus	Sulfolobaceae
Sulfophobococcus	Desulfurococcaceae
Sulfuricella	Sulfuricellaceae
Sulfurihydrogenibium	Hydrogenothermaceae
Sulfurimonas	Helicobacteraceae
Sulfurisoma	Rhodocyclaceae
Sulfurisphaera	Sulfolobaceae
Sulfuritalea	Rhodocyclaceae
Sulfurivirga	Piscirickettsiaceae
Sulfurospirillum	Campylobacteraceae
Sulfurovum	Helicobacteraceae
Sungkyunkwania	Flavobacteriaceae
Sunxiuqinia	Prolixibacteraceae
Sutterella	Sutterellaceae
Suttonella	Cardiobacteriaceae
Swaminathania	Acetobacteraceae
Swingsia	Acetobacteraceae
Symbiobacterium	Symbiobacteriaceae
Synergistes	Synergistaceae
Syntrophaceticus	Unclassified_Thermoanaerobacterales
Syntrophobacter	Syntrophobacteraceae
Syntrophobotulus	Peptococcaceae
Syntrophococcus	Lachnospiraceae
Syntrophomonas	Syntrophomonadaceae
Syntrophorhabdus	Syntrophorhabdaceae
Syntrophothermus	Syntrophomonadaceae
Syntrophus	Syntrophaceae
Tabrizicola	Rhodobacteraceae
Tahibacter	Lysobacteraceae
Taibaiella	Chitinophagaceae
Tamlana	Flavobacteriaceae
Tamlicoccus	Dermacoccaceae
Tangfeifania	Prolixibacteraceae
Tannerella	Porphyromonadaceae
Tanticharoenia	Acetobacteraceae
Taonella	Sneathiellaceae
Tardiphaga	Bradyrhizobiaceae
Tateyamaria	Rhodobacteraceae
Tatumella	Enterobacteriaceae
Taylorella	Alcaligenaceae
Telluria	Oxalobacteraceae
Telmatobacter	Acidobacteriaceae
Telmatocola	Planctomycetaceae
Telmatospirillum	Rhodospirillaceae
Temperatibacter	Temperatibacteraceae
Tenacibaculum	Flavobacteriaceae
Tenuibacillus	Bacillaceae
Tepidamorphus	Rhodobiaceae
Tepidanaerobacter	Thermoanaerobacteraceae
Tepidibacillus	Bacillaceae
Tepidibacter	Peptostreptococcaceae
Tepidicella	Comamonadaceae
Tepidimicrobium	Clostridiaceae
Tepidimonas	Unclassified_Burkholderiales
Tepidiphilus	Hydrogenophilaceae
Tepidisphaera	Tepidisphaeraceae
Terasakiella	Methylocystaceae
Teredinibacter	Unclassified_Alteromonadales
Terrabacter	Intrasporangiaceae
Terracoccus	Intrasporangiaceae
Terribacillus	Bacillaceae
Terriglobus	Acidobacteriaceae
Terrimicrobium	Unclassified_Spartobacteria
Terrimonas	Chitinophagaceae
Terrisporobacter	Clostridiaceae
Tersicoccus	Micrococcaceae
Tessaracoccus	Propionibacteriaceae
Tetragenococcus	Enterococcaceae
Tetrasphaera	Intrasporangiaceae
Texcoconibacillus	Bacillaceae
Thalassobacillus	Bacillaceae
Thalassobacter	Rhodobacteraceae
Thalassobaculum	Rhodospirillaceae
Thalassobius	Rhodobacteraceae
Thalassococcus	Rhodobacteraceae
Thalassolituus	Oceanospirillaceae
Thalassomonas	Colwelliaceae
Thalassospira	Rhodospirillaceae
Thalasstalea	Colwelliaceae
Thalassotalea	Colwelliaceae
Thauera	Rhodocyclaceae
Thermacetogenium	Thermoanaerobacteraceae
Thermaerobacter	Unclassified_Clostridiales
Thermanaeromonas	Thermoanaerobacteraceae
Thermanaerovibrio	Synergistaceae
Thermasporomyces	Nocardioidaceae
Thermicanus	Unclassified_Bacillales
Thermincola	Peptococcaceae
Thermithiobacillus	Thermithiobacillaceae
Thermoactinomyces	Thermoactinomycetaceae
Thermoactinospora	Streptosporangiaceae
Thermoanaerobacter	Thermoanaerobacteraceae
Thermoanaerobacterium	Unclassified_Thermoanaerobacterales
Thermoanaerobaculum	Unclassified_Bacteria
Thermobacillus	Paenibacillaceae
Thermobifida	Nocardiopsaceae
Thermobispora	Pseudonocardiaceae
Thermobrachium	Clostridiaceae
Thermocatellispora	Streptosporangiaceae
Thermocladium	Thermoproteaceae
Thermococcus	Thermococcaceae
Thermocrinis	Aquificaceae
Thermocrispum	Pseudonocardiaceae
Thermodesulfatator	Thermodesulfobacteriaceae
Thermodesulfobacterium	Thermodesulfobacteriaceae
Thermodesulfobium	Thermodesulfobiaceae
Thermodesulforhabdus	Syntrophobacteraceae
Thermodesulfovibrio	Nitrospiraceae
Thermodiscus	Desulfurococcaceae
Thermofilum	Thermofilaceae
Thermoflavifilum	Chitinophagaceae
Thermoflavimicrobium	Thermoactinomycetaceae
Thermoflexus	Thermoflexaceae
Thermogemmatispora	Thermogemmatisporaceae
Thermogutta	Planctomycetaceae
Thermogymnomonas	Unclassified_Thermoplasmatales
Thermohalobacter	Clostridiaceae
Thermohydrogenium	Syntrophomonadaceae
Thermoleophilum	Thermoleophilaceae
Thermolithobacter	Thermolithobacteraceae
Thermolongibacillus	Bacillaceae
Thermomarinilinea	Anaerolineaceae
Thermomicrobium	Thermomicrobiaceae
Thermomonas	Lysobacteraceae
Thermomonospora	Thermomonosporaceae
Thermonema	Flammeovirgaceae
Thermophagus	Marinilabiliaceae
Thermoplasma	Thermoplasmataceae
Thermopolyspora	Streptosporangiaceae
Thermoproteus	Thermoproteaceae
Thermorudis	Thermomicrobiaceae
Thermosediminibacter	Unclassified_Thermoanaerobacterales
Thermosinus	Veillonellaceae
Thermosipho	Thermotogaceae
Thermosphaera	Desulfurococcaceae
Thermosporothrix	Thermosporotrichaceae
Thermosulfidibacter	Unclassified_Aquificales
Thermosulfurimonas	Thermodesulfobacteriaceae
Thermosyntropha	Syntrophomonadaceae
Thermotalea	Clostridiaceae
Thermotoga	Thermotogaceae
Thermotunica	Pseudonocardiaceae
Thermovenabulum	Unclassified_Thermoanaerobacterales
Thermovibrio	Desulfurobacteriaceae
Thermovirga	Synergistaceae
Thermovorax	Unclassified_Thermoanaerobacterales
Thermus	Thermaceae
Thioalbus	Ectothiorhodospiraceae
Thioalkalibacter	Halothiobacillaceae
Thioalkalicoccus	Chromatiaceae
Thioalkalimicrobium	Piscirickettsiaceae
Thioalkalispira	Thioalkalispiraceae
Thioalkalivibrio	Ectothiorhodospiraceae
Thiobaca	Chromatiaceae
Thiobacillus	Hydrogenophilaceae
Thiobacimonas	Rhodobacteraceae
Thiobacter	Unclassified_Burkholderiales
Thiocapsa	Chromatiaceae
Thioclava	Rhodobacteraceae
Thiococcus	Chromatiaceae
Thiocystis	Chromatiaceae
Thiodictyon	Chromatiaceae
Thiofaba	Halothiobacillaceae
Thioflavicoccus	Chromatiaceae
Thiogranum	Ectothiorhodospiraceae
Thiohalobacter	Unclassified_Gammaproteobacteria
Thiohalocapsa	Chromatiaceae
Thiohalomonas	Unclassified_Gammaproteobacteria
Thiohalophilus	Thioalkalispiraceae
Thiohalorhabdus	Unclassified_Gammaproteobacteria
Thiohalospira	Ectothiorhodospiraceae
Thiolamprovum	Chromatiaceae
Thiolapillus	Unclassified_Gammaproteobacteria
Thiomicrospira	Piscirickettsiaceae
Thiomonas	Unclassified_Burkholderiales
Thiophaeococcus	Chromatiaceae
Thioprofundum	Thioalkalispiraceae
Thiopseudomonas	Pseudomonadaceae
Thioreductor	Nautiliaceae
Thiorhodococcus	Chromatiaceae
Thiorhodospira	Ectothiorhodospiraceae
Thiorhodovibrio	Chromatiaceae
Thiothrix	Thiotrichaceae
Thiovirga	Halothiobacillaceae
Thorsellia	Thorselliaceae
Tindallia	Clostridiaceae
Tissierella	Unclassified_Clostridiales
Tistlia	Rhodospirillaceae
Tistrella	Rhodospirillaceae
Tolumonas	Aeromonadaceae
Tomitella	Unclassified_Corynebacterineae
Tonsilliphilus	Dermatophilaceae
Trabulsiella	Enterobacteriaceae
Tranquillimonas	Rhodobacteraceae
Treponema	Spirochaetaceae
Trichococcus	Carnobacteriaceae
Tropheryma	Cellulomonadaceae
Tropicibacter	Rhodobacteraceae
Tropicimonas	Rhodobacteraceae
Truepera	Trueperaceae
Trueperella	Actinomycetaceae
Tsukamurella	Tsukamurellaceae
Tuberibacillus	Sporolactobacillaceae
Tumebacillus	Alicyclobacillaceae
Turicella	Corynebacteriaceae
Turicibacter	Erysipelotrichaceae
Turneriella	Leptospiraceae
Uliginosibacterium	Rhodocyclaceae
Ulvibacter	Flavobacteriaceae
Umboniibacter	Unclassified_Gammaproteobacteria
Umezawaea	Pseudonocardiaceae
Undibacterium	Oxalobacteraceae
Ureaplasma	Mycoplasmataceae
Ureibacillus	Planococcaceae
Uruburuella	Neisseriaceae
Vadicella	Rhodobacteraceae
Vagococcus	Enterococcaceae
Vallitalea	Unclassified_Clostridiales
Vampirovibrio	Bdellovibrionaceae
Varibaculum	Actinomycetaceae
Variibacter	Xanthobacteraceae
Variovorax	Comamonadaceae
Vasilyevaea	Unclassified_Rhizobiales
Veillonella	Veillonellaceae
Venenivibrio	Hydrogenothermaceae
Verminephrobacter	Comamonadaceae
Verrucomicrobium	Verrucomicrobiaceae
Verrucosispora	Micromonosporaceae
Vespertiliibacter	Pasteurellaceae
Vibrio	Vibrionaceae
Vibrionimonas	Chitinophagaceae
Victivallis	Victivallaceae
Virgibacillus	Bacillaceae
Virgisporangium	Micromonosporaceae
Viridibacillus	Bacillaceae
Vitellibacter	Flavobacteriaceae
Vitreoscilla	Neisseriaceae
Vogesella	Neisseriaceae
Volucribacter	Pasteurellaceae
Vulcanibacillus	Bacillaceae
Vulcaniibacterium	Lysobacteraceae
Vulcanisaeta	Thermoproteaceae
Vulcanithermus	Thermaceae
Vulgatibacter	Vulgatibacteraceae
Waddlia	Waddliaceae
Wandonia	Cryomorphaceae
Weeksella	Flavobacteriaceae
Weissella	Leuconostocaceae
Wenxinia	Rhodobacteraceae
Wenyingzhuangia	Flavobacteriaceae
Williamsia	Nocardiaceae
Winogradskyella	Flavobacteriaceae
Wohlfahrtiimonas	Lysobacteraceae
Wolbachia	Anaplasmataceae
Wolinella	Helicobacteraceae
Woodsholea	Hyphomonadaceae
Xanthobacter	Xanthobacteraceae
Xanthomonas	Lysobacteraceae
Xenophilus	Comamonadaceae
Xenorhabdus	Enterobacteriaceae
Xiangella	Micromonosporaceae
Xylanibacterium	Promicromonosporaceae
Xylanimicrobium	Promicromonosporaceae
Xylanimonas	Promicromonosporaceae
Xylella	Lysobacteraceae
Xylophilus	Unclassified_Burkholderiales
Yangia	Rhodobacteraceae
Yaniella	Micrococcaceae
Yeosuana	Flavobacteriaceae
Yersinia	Enterobacteriaceae
Yimella	Dermacoccaceae
Yokenella	Enterobacteriaceae
Yonghaparkia	Microbacteriaceae
Youngiibacter	Clostridiaceae
Youngimonas	Rhodobacteraceae
Yuhushiella	Pseudonocardiaceae
Zavarzinella	Planctomycetaceae
Zeaxanthinibacter	Flavobacteriaceae
Zhihengliuella	Micrococcaceae
Zhizhongheella	Unclassified_Burkholderiales
Zhongshania	Unclassified_Gammaproteobacteria
Zhouia	Flavobacteriaceae
Zimmermannella	Microbacteriaceae
Zobellella	Aeromonadaceae
Zobellia	Flavobacteriaceae
Zoogloea	Rhodocyclaceae
Zooshikella	Hahellaceae
Zunongwangia	Flavobacteriaceae
Zymobacter	Halomonadaceae
Zymomonas	Sphingomonadaceae